Old	New	Hebrew
01 - Introduction	01. Introduction	פרק א - פתיחה
01. Shabbat Rest – The Completion of Creation	01. Shabbat Rest. The Completion of Creation	א – שבת מנוחה – השלמת הבריאה
09. Zakhor – Foundations of Faith	09. Zakhor. Foundations of Faith	ט – זכור – יסודות האמונה
10. Shamor – Cessation from Crafting the Mishkan	10. Shamor. Cessation from Crafting the Mishkan	י – שמור – שביתה ממלאכת המשכן
02 - Preparing for Shabbat	02. Preparing for Shabbat	פרק ב - הכנות לשבת
05. Honoring Shabbat by Preparing One’s Self and One’s Home	05. Honoring Shabbat by Preparing One's Self and One's Home	ה – כבוד השבת בהכנת הגוף והבית
03 - Shabbat Times	03. Shabbat Times	פרק ג - זמני השבת
05. May One Pray Minĥa after Accepting Shabbat?	05. May One Pray Minha after Accepting Shabbat?	ה – האם מותר להתפלל מנחה אחר קבלת תוספת שבת
04 - Lighting Shabbat Candles	04. Lighting Shabbat Candles	פרק ד - הדלקת נרות שבת
05 - Torah Study and Prayer on Shabbat	05. Torah Study and Prayer on Shabbat	פרק ה - תורה ותפילה בשבת
08. Torah Reading at Minĥa on Shabbat	08. Torah Reading at Minha on Shabbat	ח – קריאה בתורה במנחה של שבת
09. Shnayim Mikra Ve-eĥad Targum	09. Shnayim Mikra Ve'ehad Targum	ט – שניים מקרא ואחד תרגום
10. Different Customs Relating to Shnayim Mikra Ve-eĥad Targum	10. Different Customs Relating to Shnayim Mikra Ve'ehad Targum	י – מנהגי שניים מקרא ואחד תרגום
12. Va-yekhulu	12. Va'yekhulu	יב – ויכולו
13. Magen Avot – A Concise Recap of the Amida	13. Magen Avot. A Concise Recap of the Amida	יג – מגן אבות – מעין שבע
15. The Custom of Wishing One’s Rabbi “Shabbat Shalom”	15. The Custom of Wishing One's Rabbi "Shabbat Shalom"	טו – מנהג אמירת שבת שלום לרב
06 - Laws of Kiddush	06. Laws of Kiddush	פרק ו - הלכות קידוש
07 - Shabbat Meals and Melaveh Malka	07. Shabbat Meals and Melaveh Malka	פרק ז - סעודות השבת ומלווה מלכה
01. The Mitzva of Se’udot Shabbat (Festive Shabbat Meals)	01. The Mitzva of Se'udot Shabbat (Festive Shabbat Meals)	א – מצוות סעודות שבת
03. Leĥem Mishneh (Two Loaves) and Cutting the Bread	03. Lehem Mishneh (Two Loaves) and Cutting the Bread	ג – לחם משנה ובציעת הפת
05. Se’uda Shlishit	05. Se'uda Shlishit	ה – סעודה שלישית
06. Birkat Ha-mazon	06. Birkat Ha'mazon	ו – ברכת המזון
08 - Havdala and Saturday Night	08. Havdala and Saturday Night	פרק ח -הבדלה ומוצאי שבת
09 - The Principles of the Melakhot	09. The Principles of the Melakhot	פרק ט - כללי המלאכות
01. The Torah’s Commandment	01. The Torah's Commandment	א – המצווה בתורה
05. Davar She-eino Mitkaven and Psik Reisha	05. Davar She'eino Mitkaven and Psik Reisha	ה – דבר שאינו מתכוון ופסיק רישא
06. Melakha She-eina Tzerikha Le-gufah	06. Melakha She'eina Tzerikha Le'gufah	ו – מלאכה שאינה צריכה לגופה
10. Children, Non-Jews, and Animals	10. Children, Non Jews, and Animals	י – ילדים וגוים ובעלי חיים
11. Shvut Di-shvut for the Sake of a Mitzva or Great Necessity	11. Shvut Di'shvut for the Sake of a Mitzva or Great Necessity	יא – 'שבות דשבות' לצורך מצווה וצורך גדול
10 - Bishul (Cooking)	10. Bishul (Cooking)	פרק י - בישול
18. Hanaĥa	18. Hanaha	יח – הנחה בשבת – שלא יעשה פעולה שנראית כבישול
19. Haĥzara	19. Hahzara	יט – החזרה בשבת
20. Hanaĥa and Haĥzara on a Plata	20. Hanaha and Hahzara on a Plata	כ – דינים בהנחה והחזרה על פלטה
11 - Borer (Separating)	11. Borer (Separating)	פרק יא - בורר
12 - Food Preparation	12. Food Preparation	פרק יב - הכנת מאכלים
01. Toĥen	01. Tohen	א – מלאכת טוחן
13 - Melakhot Pertaining to Clothing	13. Melakhot Pertaining to Clothing	פרק יג - מלאכות הבגד
11. Kore’a	11. Kore'a	יא – קורע
14 - Personal Grooming	14. Personal Grooming	פרק יד - הטיפול בגוף
02. Gozez and Ĥovel of Human Beings	02. Gozez and Hovel of Human Beings	ב – גוזז וחובל באדם
15 - Boneh and Soter	15. Boneh and Soter	פרק טו - בונה סותר בבית וכלים
01. The Principles of Boneh, Soter, and Makeh Be-fatish	01. The Principles of Boneh, Soter, and Makeh Be'fatish	א – כללי בונה וסותר ומכה בפטיש
10. Meĥatekh	10. Mehatekh	י – מחתך
16 - Mav’ir and Mekhabeh	16. Mav'ir and Mekhabeh	פרק טז - מבעיר ומכבה
01. The Melakha of Hav’ara	01. The Melakha of Hav'ara	א – מלאכת הבערה
02. The Laws of Hav’ara	02. The Laws of Hav'ara	ב – פרטי הלכות הבערה
05. The Melakha of Mekhabeh and the Meaning of Melakha She-eina Tzerikha Le-gufah	05. The Melakha of Mekhabeh and the Meaning of Melakha She'eina Tzerikha Le'gufah	ה – מלאכת מכבה וביאור 'מלאכה שאינה צריכה לגופה'
17 - Electricity and Electrical Appliances	17. Electricity and Electrical Appliances	פרק יז - חשמל ומכשיריו
08. Opening a Refrigerator or Oven, and Entering an Air-Conditioned Room	08. Opening a Refrigerator or Oven, and Entering an Air Conditioned Room	ח – פתיחת מקרר ותנור חשמלי וכניסה לחדר עם מזגן
18 - Kotev, Moĥek, and Tzove’a	18. Kotev, Mohek, and Tzove'a	פרק יח - כותב מוחק וצובע
01. Kotev and Moĥek	01. Kotev and Mohek	א – כתיבה ומחיקה
02. Defining the Prohibition of Writing and Exploring Leniencies for Life-Threatening Situations	02. Defining the Prohibition of Writing and Exploring Leniencies for Life Threatening Situations	ב – גדרי האיסור וההיתרים לצורך פיקוח נפש
06. Mafshit, Me’abed, Memaĥek, and Mesartet	06. Mafshit, Me'abed, Memahek, and Mesartet	ו – מלאכת מפשיט, מעבד, ממחק ומשרטט
19 - Agricultural Melakhot (Ĥoresh, Zore’a, Kotzer, and Me’amer)	19. Agricultural Melakhot (Horesh, Zore'a, Kotzer, and Me'amer)	פרק יט - מלאכות שבצומח
01. Ĥoresh	01. Horesh	א – חורש
03. Zore’a	03. Zore'a	ג – זורע
11. Me’amer	11. Me'amer	יא – מעמר
20 - Animals	20. Animals	פרק כ - בעלי חיים
08. Slaughtering (Shoĥet)	08. Slaughtering (Shohet)	ח – שוחט
09. Wounding (Ĥovel)	09. Wounding (Hovel)	ט – חובל
21 - Hotza’ah	21. Hotza'ah	פרק כא - הלכות הוצאה
01. The Melakha of Hotza’ah	01. The Melakha of Hotza'ah	א – מלאכת הוצאה
04. The Reason Behind the Prohibition of Carrying Four Amot in a Reshut Ha-Rabim	04. The Reason Behind the Prohibition of Carrying Four Amot in a Reshut HaRabim	ד – טעם איסור טלטול ד' אמות ב'רשות הרבים'
06. Carrying Less than Four Amot in a Reshut Ha-Rabim	06. Carrying Less than Four Amot in a Reshut HaRabim	ו – טלטול פחות פחות מד' אמות ברשות הרבים
08. Reshut Ha-rabim as Defined by Torah Law	08. Reshut Ha'rabim as Defined by Torah Law	ח – רשות הרבים מן התורה
12. Items That Serve the Body – Glasses and Bandages	12. Items That Serve the Body. Glasses and Bandages	יב – תשמישי הגוף – משקפיים ותחבושת
13. Canes, Seeing-Eye Dogs, and Wheelchairs	13. Canes, Seeing Eye Dogs, and Wheelchairs	יג – מקל הליכה וכלב נחייה וכסא גלגלים
22 - The Spirit of Shabbat	22. The Spirit of Shabbat	פרק כב - צביון השבת
05. Court Activity, Weddings, Teruma and Ma’aser	05. Court Activity, Weddings, Teruma and Ma'aser	ה – מעשה בית דין, נישואין, תרומות ומעשרות
09. Walking for Non-Shabbat Purposes	09. Walking for Non Shabbat Purposes	ט – הליכה לצורך חול
23 - Muktzeh	23. Muktzeh	פרק כג - מוקצה
03. Muktzeh Maĥmat Gufo	03. Muktzeh Mahmat Gufo	ג – מוקצה מחמת גופו
04. Muktzeh Maĥmat Ĥesron Kis	04. Muktzeh Mahmat Hesron Kis	ד – מוקצה מחמת חסרון כיס
05. Basis Le-davar Ha-asur and Conscious Placement	05. Basis Le'davar Ha'asur and Conscious Placement	ה – בסיס לדבר האסור – נעשה בכוונה
06. More on Basis Le-davar Ha-asur	06. More on Basis Le'davar Ha'asur	ו – המשך
07. Kelim She-melakhtam Le-isur	07. Kelim She'melakhtam Le'isur	ז – כלים שמלאכתם לאיסור
09. Kelim She-melakhtam Le-heter, Food, and Books	09. Kelim She'melakhtam Le'heter, Food, and Books	ט – כלים שמלאכתם להיתר ומאכלים וספרים
10. An Item that was Muktzeh Throughout Bein Ha-shmashot	10. An Item that was Muktzeh Throughout Bein Ha'shmashot	י – מוקצה בבין השמשות משום איסור או מצווה
12. The Permissibility of Removing Filthy Items – “Graf Shel Re’i”	12. The Permissibility of Removing Filthy Items. "Graf Shel Re'i"	יב – היתר סילוק דברים מטונפים – גרף של רעי
13. Broken Kelim and Worn-Out Clothing	13. Broken Kelim and Worn Out Clothing	יג – כלים שנשברו ובגדים שהתבלו
24 - Children	24. Children	פרק כד - דיני קטן
01. The Mitzva of Ĥinukh, Educating One’s Children	01. The Mitzva of Hinukh, Educating One's Children	א – מצוות חינוך
25 – Melakha Performed by a Non-Jew	25. Melakha Performed by a Non Jew	פרק כה - מלאכת גוי
01. Asking a Non-Jew to Do Melakha on Shabbat	01. Asking a Non Jew to Do Melakha on Shabbat	א – איסור אמירה לנכרי
02. Benefiting from a Melakha That a Non-Jew Performed for Himself	02. Benefiting from a Melakha That a Non Jew Performed for Himself	ב – מותר ליהנות ממלאכה שעשה הגוי עבור עצמו
05. A Non-Jew’s Melakha for Someone Sick or Suffering (and Air Conditioners)	05. A Non Jew's Melakha for Someone Sick or Suffering (and Air Conditioners)	ה – היתר מלאכת גוי עבור חולה ועבור מצטער (מזגן)
08. Non-Jewish Contractors	08. Non Jewish Contractors	ח – עבודת גוי בקבלנות
26 – Ma’aseh Shabbat and Lifnei Iver	26. Ma'aseh Shabbat and Lifnei Iver	פרק כו - מעשה שבת ולפני עיוור
09. Interacting with Non-Observant Jews and Lifnei Iver	09. Interacting with Non Observant Jews and Lifnei Iver	ט – בין דתיים לחילוניים (לפני עיוור)
27 – Sick People and Saving Lives	27. Sick People and Saving Lives	פרק כז - פיקוח נפש וחולה
01. The Principles of Piku’aĥ Nefesh (Saving a Life)	01. The Principles of Piku'ah Nefesh (Saving a Life)	א – כללי פיקוח נפש
04. Using a Non-Jew or Child to Minimize Shabbat Desecration	04. Using a Non Jew or Child to Minimize Shabbat Desecration	ד – האם טוב להיעזר בגוי או קטן כדי למעט באיסור
13. A Commanding Officer’s Authority During Wartime and Normal Times	13. A Commanding Officer's Authority During Wartime and Normal Times	יג – מצב מלחמה ומצב שיגרה בצבא וסמכות המפקד
28 – Illness That Is Not Life-Threatening	28. Illness That Is Not Life Threatening	פרק כח - חולה שאינו מסוכן
04. The Enactment Against Medicine – Grinding Ingredients	04. The Enactment Against Medicine. Grinding Ingredients	ד – גזירת תרופות – שחיקת סממנים
14. Seeing a Non-Observant Doctor	14. Seeing a Non Observant Doctor	יד – האם מותר ללכת לרופא חילוני
29 – Eruvin	29. Eruvin	פרק כט - עירובין
02. Tzurat Ha-petaĥ	02. Tzurat Ha'petah	ב – צורת הפתח
04. Fences, Breaches, and a Tel Ha-mitlaket	04. Fences, Breaches, and a Tel Ha'mitlaket	ד – גדרות, פרצות ותל המתלקט
05. Forming a Partnership Using Two Meals’ Worth of Food	05. Forming a Partnership Using Two Meals' Worth of Food	ה – השיתוף שנעשה על ידי מזון שתי סעודות
30 – Teĥum Shabbat	30. Tehum Shabbat	פרק ל - תחומי שבת
01. General Principles of Teĥum Shabbat	01. General Principles of Tehum Shabbat	א – כללי מצוות תחומין
02. Squaring the Teĥum	02. Squaring the Tehum	ב – ריבוע התחום
03. Teĥum Shabbat Is Individual	03. Tehum Shabbat Is Individual	ג – תחום שבת יחודי לכל אדם
05. Measuring Teĥum in Rabbinic Times and Nowadays	05. Measuring Tehum in Rabbinic Times and Nowadays	ה – צורת המדידה בזמן חז"ל וכיום
11. Traveling Beyond the Teĥum and Items Arriving from Beyond the Teĥum	11. Traveling Beyond the Tehum and Items Arriving from Beyond the Tehum	יא – היוצא מתחום שבת ודברים הבאים מחוץ לתחום
12. Eruv Teĥumin	12. Eruv Tehumin	יב – עירוב תחומין
13. Placing the Eruv Teĥumin and Reciting the Berakha	13. Placing the Eruv Tehumin and Reciting the Berakha	יג – סדר הנחת 'עירוב תחומין' וברכתו
01 - Fundamentals of the Laws of Prayer	01. Fundamentals of the Laws of Prayer	פרק א - יסודות הלכות תפילה
01 – Prayer	01. Prayer	א – התפילה
02 – The Prayers of Our Ancestors and Prophets	02. The Prayers of Our Ancestors and Prophets	ב – תפילותיהם של האבות והנביאים
3 – The Effect of Prayer	3. The Effect of Prayer	ג – פעולתה של התפילה
04 – Is Prayer a Biblical Obligation?	04. Is Prayer a Biblical Obligation?	ד – האם חיובה מהתורה
05 – The Institution of Prayer by Anshei Knesset HaGedolah	05. The Institution of Prayer by Anshei Knesset HaGedolah	ה – תקנת התפילה על ידי אנשי כנסת הגדולה
06 – The Standardized Wording (Nusach)	06. The Standardized Wording (Nusach)	ו – הנוסח הקבוע
07 – Establishing Three Prayers	07. Establishing Three Prayers	ז – תקנת שלוש התפילות
08 – Kavanah and Those Who Find It Difficult to Concentrate	08. Kavanah and Those Who Find It Difficult to Concentrate	ח – כוונה והמתקשים לכוון
09 – Hearing the Words One Utters and the Law of Hirhur	09. Hearing the Words One Utters and the Law of Hirhur	ט – להשמיע לאוזנו ודין הרהור
10 – The Language of Prayer	10. The Language of Prayer	י – לשון התפילה
02 - The Minyan	02. The Minyan	פרק ב - המניין
01 – The Virtue of a Minyan	01. The Virtue of a Minyan	א – מעלת המניין
02 – The Virtue of Prayer in a Minyan	02. The Virtue of Prayer in a Minyan	ב – טעם למעלת התפילה במניין
03 – What Is Prayer in a Minyan?	03. What Is Prayer in a Minyan?	ג – מהי תפילה במניין
04 – The Extent of One’s Obligation to Pray in a Minyan	04. The Extent of One's Obligation to Pray in a Minyan	ד – מידת החיוב של התפילה במניין
05 – Priorities Pertaining to Prayer in a Minyan	05. Priorities Pertaining to Prayer in a Minyan	ה – סדרי עדיפויות ביחס לתפילה במניין
06 – Who Can Be Counted in a Minyan?	06. Who Can Be Counted in a Minyan?	ו – מי מצטרף למניין
07 – Is a Person Praying the Amidah Counted as Part of the Minyan?	07. Is a Person Praying the Amidah Counted as Part of the Minyan?	ז – האם העומד בתפילה מצטרף למניין
08 – Counting a Non-Religious Jew as Part of the Minyan	08. Counting a Non Religious Jew as Part of the Minyan	ח – צירוף חילוני למניין
09 – How Is a Person Counted in a Minyan?	09. How Is a Person Counted in a Minyan?	ט – כיצד מצטרפים למניין
10 – A Diminished Minyan	10. A Diminished Minyan	י – מניין שנתמעט
03 - The Place of Prayer	03. The Place of Prayer	פרק ג - מקום התפילה
01 – The Mitzvah to Pray in a Synagogue	01. The Mitzvah to Pray in a Synagogue	א – מצווה להתפלל בבית כנסת
02 – Establishing a Regular Place to Pray	02. Establishing a Regular Place to Pray	ב – קביעת מקום לתפילה
03 – In Which Synagogue Is It Preferable to Pray?	03. In Which Synagogue Is It Preferable to Pray?	ג – באיזה בית כנסת עדיף להתפלל
04 – One May Not Pray in a High Place	04. One May Not Pray in a High Place	ד – אין להתפלל במקום גבוה
05 – One Should Enter Two “Doorways”	05. One Should Enter Two "Doorways"	ה – יכנס שני פתחים
06 – Nothing Should Separate a Person from the Wall While Praying	06. Nothing Should Separate a Person from the Wall While Praying	ו – שלא יהא דבר חוצץ בינו לקיר
07 – One May Not Pray Near His Primary Rabbi	07. One May Not Pray Near His Primary Rabbi	ז – לא יתפלל סמוך לרבו המובהק
08 – A Proper Place to Pray	08. A Proper Place to Pray	ח – מקום ראוי לתפילה
09 – Areas Free from Excrement and Foul Odors	09. Areas Free from Excrement and Foul Odors	ט – נקיות המקום מצואה וריחות רעים
10 – Additional Laws	10. Additional Laws	י – דינים נוספים
11 – The Prohibition of Reciting Matters of Sanctity in Front of “Ervah”	11. The Prohibition of Reciting Matters of Sanctity in Front of "Ervah"	יא – איסור אמירת דברים שבקדושה מול ערווה
04 - The Chazan and the Mourner’s Kaddish	04. The Chazan and the Mourner's Kaddish	פרק ד - החזן וקדיש של אבלים
01 – An Appropriate Prayer Leader	01. An Appropriate Prayer Leader	א – הראוי להיות שליח ציבור
02 – Chazanut for the Sake of Heaven	02. Chazanut for the Sake of Heaven	ב – חזנות לשם שמים
03 – Appointing a Chazan	03. Appointing a Chazan	ג – מינוי החזן
04 – Indecent Attire and the Importance of a Beard	04. Indecent Attire and the Importance of a Beard	ד – הלבוש הראוי לתפילה, פוחח ושנתמלא זקנו
05 – The Mourner’s Prayer	05. The Mourner's Prayer	ה – תפילת אבלים
06 – The Duration of the Kaddish Recital and the Yahrtzeit Day	06. The Duration of the Kaddish Recital and the Yahrtzeit Day	ו – עד מתי נוהגים לומר קדיש, ויום היורצייט
07 – Order of Precedence	07. Order of Precedence	ז – סדרי קדימה
08 – Saying Kaddish for a Person Who Does Not Have an Adult Son	08. Saying Kaddish for a Person Who Does Not Have an Adult Son	ח – אמירת קדיש על מי שאין לו בן גדול
05 - Preparations for Prayer	05. Preparations for Prayer	פרק ה - הכנות לתפילה
01 – Emotional Preparation	01. Emotional Preparation	א – הכנה נפשית
02 – Washing One’s Hands	02. Washing One's Hands	ב – נטילת ידיים
03 – Kippah and Belt	03. Kippah and Belt	ג – כיפה וחגורה
04 – The Appropriate Dress for Prayer	04. The Appropriate Dress for Prayer	ד – מהו הלבוש הראוי לתפילה
05 – Detailed Laws of One’s Dress for Prayer	05. Detailed Laws of One's Dress for Prayer	ה – פרטי דינים של הלבוש בתפילה
06 – One May Not Bring to Synagogue Children Who Are Likely to Disrupt	06. One May Not Bring to Synagogue Children Who Are Likely to Disrupt	ו – שלא להביא לבית הכנסת ילדים העלולים להפריע
07 – Preventing Possible Disruptions in Prayer	07. Preventing Possible Disruptions in Prayer	ז – מניעת דברים הטורדים בתפילה
08 – One Who Must Relieve Himself While Praying	08. One Who Must Relieve Himself While Praying	ח – דין הנצרך לנקביו לעניין תפילה
09 – One Who Needs to Relieve Himself Before Reciting Other Matters of Sanctity	09. One Who Needs to Relieve Himself Before Reciting Other Matters of Sanctity	ט – דין הנצרך לנקביו לשאר עניינים שבקדושה
10 – One Who Needs to Relieve Himself in the Middle of Praying	10. One Who Needs to Relieve Himself in the Middle of Praying	י – מי שבאמצע תפילתו הוצרך להתפנות
11 – One Who Is Tipsy or Drunk	11. One Who Is Tipsy or Drunk	יא – שיכור ושתוי
06 - Nusach: Wording of Prayer	06. Nusach: Wording of Prayer	פרק ו - הנוסחים ומנהגי העדות
01 – The Differences in Nusach	01. The Differences in Nusach	א – שינויי הנוסחים
02 – No Nusach Should Be Considered More Preferable than Another	02. No Nusach Should Be Considered More Preferable than Another	ב – אין להחשיב נוסח אחד כעדיף מחבירו
03 – In What Cases Is One Permitted to Change His Nusach?	03. In What Cases Is One Permitted to Change His Nusach?	ג – דין מהגרים וקהילות שנדדו ממקומם
04 – Immigrants and Communities that Migrated	04. Immigrants and Communities that Migrated	ד – באיזה מקרים מותר לשנות את הנוסח
05 – Praying in a Minyan Conducted in a Different Nusach	05. Praying in a Minyan Conducted in a Different Nusach	ה – המתפלל במניין בעל נוסח אחר
06 – Preserving Minhagim versus Strengthening the Community	06. Preserving Minhagim versus Strengthening the Community	ו – שמירת המנהגים מול חיזוק הקהילה
07 – Those Accustomed to a Different Nusach	07. Those Accustomed to a Different Nusach	ז – המתרגלים לנוסח עדה אחרת
08 – Ashkenazim Who Pray with a Sephardic Pronunciation	08. Ashkenazim Who Pray with a Sephardic Pronunciation	ח – אשכנזים שמתפללים במבטא ספרדי
09 – Members of Different Ethnic Groups Praying Together	09. Members of Different Ethnic Groups Praying Together	ט – בני עדות שונות המתפללים ביחד
07 - Waking Up in the Morning	07. Waking Up in the Morning	פרק ז - השכמת הבוקר
01 – Wake Up Like a Lion	01. Wake Up Like a Lion	א – יקום כארי
02 – Dressing Modestly	02. Dressing Modestly	ב – התלבשות בצניעות
03 – The Extra Pious Custom with Regard to Putting on One’s Clothes and Shoes	03. The Extra Pious Custom with Regard to Putting on One's Clothes and Shoes	ג – מנהג חסידות בלבישת הבגדים ונעילת הנעליים
08 - Washing One’s Hands in the Morning	08. Washing One's Hands in the Morning	פרק ח - נטילת ידיים שחרית
01 – Morning Washing	01. Morning Washing	א – נטילת ידיים של שחרית
02 – Hand Washing Concerning One Who Did Not Sleep All Night	02. Hand Washing Concerning One Who Did Not Sleep All Night	Missing Section
03 – Ruach Ra’ah (Evil Spirit)	03. Ruach Ra'ah (Evil Spirit)	ב – רוח-רעה
04 – Ruach Ra’ah Today	04. Ruach Ra'ah Today	ג – רוח-רעה בזמננו
05 – The Time to Recite Al Netilat Yadayim	05. The Time to Recite Al Netilat Yadayim	ד – זמן ברכת 'על נטילת ידיים'
06 – Hand Washing Following Daytime Sleep	06. Hand Washing Following Daytime Sleep	ה – נטילת ידיים לאחר שינה ביום ולניעור בלילה
07 – Waking in the Middle of the Night to Tend to a Baby or for Any Other Reason	07. Waking in the Middle of the Night to Tend to a Baby or for Any Other Reason	ו – קימה באמצע הלילה לתינוק או לצורך אחר
08 – Food Touched by Unwashed Hands	08. Food Touched by Unwashed Hands	ז – מאכלים שנגעו בהם לפני הנטילה
09 – Minors	09. Minors	ח – קטנים
09 - Birkot HaShachar – The Morning Blessings	09. Birkot HaShachar. The Morning Blessings	פרק ט - ברכות השחר
01 – Blessings of Thanks	01. Blessings of Thanks	א – ברכות ההודאה
02 – The Order of the Morning Blessings	02. The Order of the Morning Blessings	ב – סדר ברכות השחר
03 – Birkot HaShachar for One Who Does Not Derive Pleasure	03. Birkot HaShachar for One Who Does Not Derive Pleasure	ג – ברכות השחר למי שלא נהנה
04 – Until When May One Recite Birkot HaShachar?	04. Until When May One Recite Birkot HaShachar?	ד – עד מתי זמנן של ברכות השחר
05 – The Time to Recite Birkot HaShachar for One Who Wakes Up in the Middle of the Night	05. The Time to Recite Birkot HaShachar for One Who Wakes Up in the Middle of the Night	ה – זמן ברכות השחר למי שקם באמצע הלילה
06 – One Who Was Awake All Night	06. One Who Was Awake All Night	ו – מי שהיה ער כל הלילה
10 - Birkot HaTorah – The Blessings on the Torah	10. Birkot HaTorah: The Blessings on the Torah	פרק י - ברכת התורה
01 – The Value of Birkot HaTorah	01. The Value of Birkot HaTorah	א – ערכה של ברכת התורה
02 – The Content of the Torah Blessings and the Ruling Regarding Ahavat Olam	02. The Content of the Torah Blessings and the Ruling Regarding Ahavat Olam	ב – תוכן ברכת התורה ודין "אהבת עולם"
03 – Is the Recital of Birkot HaTorah a Biblical Commandment?	03. Is the Recital of Birkot HaTorah a Biblical Commandment?	ג – האם המצווה לברך מהתורה
04 – Before What Type of Learning Must the Berachot Be Recited?	04. Before What Type of Learning Must the Berachot Be Recited?	ד – לפני איזה לימוד חייבים לברך
05 – Birkot HaTorah for the Whole Day	05. Birkot HaTorah for the Whole Day	ה – ברכת התורה לכל היום
06 – Is Sleep Considered an Interruption Regarding Birkot HaTorah?	06. Is Sleep Considered an Interruption Regarding Birkot HaTorah?	ו – האם שינה נחשבת הפסקה לברכת התורה
07 – One Who Was Awake All Night	07. One Who Was Awake All Night	ז – היה ער כל הלילה
11 - The Times of Keriat Shema and Shacharit	11. The Times of Keriat Shema and Shacharit	פרק יא - זמן ק"ש ותפילת שחרית
01 – The Morning	01. The Morning	א – זמני הבוקר
02 – Calculation of the Morning Times	02. Calculation of the Morning Times	ב – חשבון זמני הבוקר
03 – The Time of Keriat Shema	03. The Time of Keriat Shema	ג – זמן קריאת שמע
04 – The Time of the Amidah	04. The Time of the Amidah	ד – זמן תפילה
05 – Vatikin at Netz HaChamah	05. Vatikin at Netz HaChamah	ה – תפילת 'ותיקין' ב'הנץ החמה'
06 – The Precise Times of Vatikin and Netz	06. The Precise Times of Vatikin and Netz	ו – זמן 'ותיקין' ו'הנץ' המדויק
07 – How Early May One Begin to Pray?	07. How Early May One Begin to Pray?	ז – עד כמה אפשר להקדים את התפילה
08 – How Early Is One Permitted to Pray in Extenuating Circumstances?	08. How Early Is One Permitted to Pray in Extenuating Circumstances?	ח – עד כמה אפשר להקדים את התפילה בשעת הדחק
09 – Praying Vatikin Individually versus Praying in a Minyan	09. Praying Vatikin Individually versus Praying in a Minyan	ט – ותיקין ביחיד מול תפילה במניין
10 – The Proportional Hours and Their Corresponding Laws	10. The Proportional Hours and Their Corresponding Laws	י – השעות הזמניות ודיניהן
11 – The Practical Halachah Regarding the Final Time to Recite Shema and Pray the Amidah	11. The Practical Halachah Regarding the Final Time to Recite Shema and Pray the Amidah	יא – הלכה למעשה בסוף זמן ק"ש ותפילה
12 – Praying in a Minyan vs. Abiding by the Times	12. Praying in a Minyan vs. Abiding by the Times	יב – תפילה במניין מול שמירת הזמנים
12 - Before the Shacharit Prayer	12. Before the Shacharit Prayer	פרק יב - לקראת תפילת שחרית
01 – Greetings Before Prayer	01. Greetings Before Prayer	א – הקדמת שלום לפני התפילה
02 – One May Not Deal with Personal Business Before Prayer	02. One May Not Deal with Personal Business Before Prayer	ב – שלא לעסוק בעסקיו קודם התפילה
03 – Permitted Activities Before Praying	03. Permitted Activities Before Praying	ג – דברים שמותר לעשות לפני התפילה
04 – Ritual Immersion (Tevilah), Bathing, and Shaving	04. Ritual Immersion (Tevilah), Bathing, and Shaving	ד – טבילה רחצה וגילוח
05 – One Who Is Traveling	05. One Who Is Traveling	ה – היוצא לדרך
06 – Eating and Drinking Before Prayer	06. Eating and Drinking Before Prayer	ו – אכילה ושתייה קודם התפילה
07 – Coffee, Tea, and Cake Before Prayer	07. Coffee, Tea, and Cake Before Prayer	ז – קפה תה ועוגות לפני התפילה
08 – Eating and Drinking Before Amud HaShachar	08. Eating and Drinking Before Amud HaShachar	ח – אכילה ושתייה לפני עמוד השחר
09 – Tefillin and Tzitzit During Keriat Shema and Shacharit	09. Tefillin and Tzitzit During Keriat Shema and Shacharit	ט – תפילין וציצית בקריאת שמע ותפילת שחרית
10 – Laws Pertaining to Tzitzit and Tefillin for Shacharit	10. Laws Pertaining to Tzitzit and Tefillin for Shacharit	י – דינים בהנחת ציצית ותפילין לקראת שחרית
13 - Korbanot – The Passages of the Sacrificial Offerings	13. Korbanot. The Passages of the Sacrificial Offerings	פרק יג - סדר קרבנות
01 – Is It an Obligation to Recite the Korbanot Passages?	01. Is It an Obligation to Recite the Korbanot Passages?	א – האם חובה לומר סדר קרבנות
02 – The Reason for the Recital of the Korbanot and the Different Stages of Prayer	02. The Reason for the Recital of the Korbanot and the Different Stages of Prayer	ב – טעם לאמירת הקרבנות ושלבי התפילה
03 – The Source for the Recital of the Korbanot	03. The Source for the Recital of the Korbanot	ג – מקור לאמירת קרבנות
04 – The Korbanot Passages	04. The Korbanot Passages	ד – סדר קרבנות
05 – The Reason for the Tamid Offering	05. The Reason for the Tamid Offering	ה – טעם לקרבן התמיד
06 – The Reason for the Ketoret	06. The Reason for the Ketoret	ו – טעם הקטורת
14 - Pesukei d’Zimrah	14. Pesukei d'Zimrah	פרק יד - פסוקי דזמרה
01 – The Reason for Its Recital	01. The Reason for Its Recital	א – טעם אמירתם
02 – What Are Pesukei d’Zimrah?	02. What Are Pesukei d'Zimrah?	ב – מהם פסוקי דזמרה
03 – Customs and Kavanah Regarding Their Recital	03. Customs and Kavanah Regarding Their Recital	ג – מנהגים וכוונה באמירתם
04 – The Laws Concerning Interruptions in Pesukei d’Zimrah	04. The Laws Concerning Interruptions in Pesukei d'Zimrah	ד – דיני הפסקה בפסוקי דזמרה
05 – What Parts May Be Omitted to Enable Praying in a Minyan?	05. What Parts May Be Omitted to Enable Praying in a Minyan?	ה – על מה ראוי לדלג כדי להגיע לתפילה במניין
06 – The Order of Preference Regarding Omissions	06. The Order of Preference Regarding Omissions	ו – סדרי עדיפות בדילוג
15 - Keriat Shema	15. Keriat Shema	פרק טו - קריאת שמע
01 – The Mitzvah of Keriat Shema (The Recital of Shema)	01. The Mitzvah of Keriat Shema (The Recital of Shema)	א – מצוות קריאת שמע
02 – Remembering the Exodus	02. Remembering the Exodus	ב – זכירת יציאת מצרים
03 – The Content of the Shema Paragraph	03. The Content of the Shema Paragraph	ג – תוכן פרשת שמע
04 – The Second and Third Paragraphs	04. The Second and Third Paragraphs	ד – הפרשה השנייה והשלישית
05 – The Significance of the Exodus	05. The Significance of the Exodus	ה – משמעותה של יציאת מצרים
06 – Kavanah While Reciting the First Verse	06. Kavanah While Reciting the First Verse	ו – כוונה בפסוק הראשון
07 – The Second Verse and Its Kavanah	07. The Second Verse and Its Kavanah	ז – פסוק שני וכוונתו
08 – Mitzvot Require Kavanah	08. Mitzvot Require Kavanah	ח – מצוות צריכות כוונה
09 – The Laws of Reciting Shema	09. The Laws of Reciting Shema	ט – דיני אמירתה
10 – The Manner in which to Recite Shema	10. The Manner in which to Recite Shema	י – אופן אמירתה
11 – Tefillin and Tzitzit while Reciting Shema	11. Tefillin and Tzitzit while Reciting Shema	יא – תפילין וציצית בקריאת שמע
12 – 248 Words	12. 248 Words	יב – רמ"ח תיבות
16 - Birkot Keriat Shema	16. Birkot Keriat Shema	פרק טז - ברכות קריאת שמע
01 – The Significance of the Berachot	01. The Significance of the Berachot	א – משמעות הברכות
02 – The Link between Pesukei d’Zimrah and Birkot Keriat Shema	02. The Link between Pesukei d'Zimrah and Birkot Keriat Shema	ב – החיבור בין פסוקי דזמרה לברכות ק"ש
03 – Barchu	03. Barchu	ג – ברכו
04 – Kedushat Yotzer and Responding Amen to the Berachot	04. Kedushat Yotzer and Responding Amen to the Berachot	ד – קדושת יוצר ואמן על הברכות
05 – Responding to Matters of Sanctity in Birkot Keriat Shema	05. Responding to Matters of Sanctity in Birkot Keriat Shema	ה – עניית דברים שבקדושה בברכות קריאת שמע
06 – Interruption for a Respected Person	06. Interruption for a Respected Person	ו – הפסקה מפני אדם מכובד
07 – Adjoining Redemption to Prayer	07. Adjoining Redemption to Prayer	ז – סמיכת גאולה לתפילה
17 - The Amidah	17. The Amidah	פרק יז - תפילת עמידה
01 – The Amidah Is the Essence of Prayer	01. The Amidah Is the Essence of Prayer	א – תפילת עמידה עיקר התפילה
02 – Three Steps Forward Before the Amidah	02. Three Steps Forward Before the Amidah	ב – שלוש פסיעות לקראת התפילה
03 – Facing Jerusalem	03. Facing Jerusalem	ג – לכיוון ירושלים
04 – Standing and Putting One’s Feet Together	04. Standing and Putting One's Feet Together	ד – עמידה ורגליים צמודות
05 – Body and Hand Positions	05. Body and Hand Positions	ה – תנוחת הגוף והידיים
06 – Bowing Down During the Amidah	06. Bowing Down During the Amidah	ו – הכריעות בתפילה
07 – Praying Silently	07. Praying Silently	ז – תפילה בלחש
08 – In Any Language	08. In Any Language	ח – בכל לשון
09 – Kavanah	09. Kavanah	ט – כוונה
10 – The Order of the Berachot	10. The Order of the Berachot	י – סדר הברכות בתפילת שמונה עשרה
11 – Personal Requests in the Amidah	11. Personal Requests in the Amidah	יא – בקשות אישיות בתפילה
12 – The Conclusion of the Amidah	12. The Conclusion of the Amidah	יב – סיום התפילה
13 – Three Steps Back	13. Three Steps Back	יג – שלוש פסיעות לאחריו
14 – How Long Must One Stand at a Distance	14. How Long Must One Stand at a Distance	יד – עד מתי יעמוד בריחוק מקום
15 – When Is It Permissible to Interrupt the Amidah?	15. When Is It Permissible to Interrupt the Amidah?	טו – מתי מותר להפסיק בתפילת עמידה
16 – One Who Is Traveling When the Time to Pray Arrives	16. One Who Is Traveling When the Time to Pray Arrives	טז – הנוסע והגיע זמן תפילה
17 – One May Not Sit Within Four Amot of a Person Reciting the Amidah	17. One May Not Sit Within Four Amot of a Person Reciting the Amidah	יז – אין לשבת בתוך ד' אמות של המתפלל
18 – It Is Forbidden to Pass in Front of People Reciting the Amidah	18. It Is Forbidden to Pass in Front of People Reciting the Amidah	יח – אסור לעבור כנגד המתפללים
19 – The Practical Halachah	19. The Practical Halachah	יט – הלכה למעשה
20 – One Who Finishes Reciting the Amidah	20. One Who Finishes Reciting the Amidah	כ – המסיים תפילתו
21 – Additional Details of Certain Laws	21. Additional Details of Certain Laws	כא – עוד פרטי דינים
18 - Errors, Additions, and Omissions in the Amidah	18. Errors, Additions, and Omissions in the Amidah	פרק יח - טעויות הזכרות ושכחה
01 – Error, Omission, and Interruption in the Amidah	01. Error, Omission, and Interruption in the Amidah	א – דילוג טעות והפסק בתפילה
02 – Additions Pertaining to Particular Days	02. Additions Pertaining to Particular Days	ב – תוספות מעניינו של יום
03 – The Voluntary Prayer (Tefillat Nedavah) and Laws in Situations of Uncertainty	03. The Voluntary Prayer (Tefillat Nedavah) and Laws in Situations of Uncertainty	ג – תפילת נדבה ודיני ספקות
19 - The Chazan’s Repetition of the Amidah	19. The Chazan's Repetition of the Amidah	פרק יט - חזרת הש"ץ
01 – The Enactment of the Amidah Repetition (Chazarat HaShatz)	01. The Enactment of the Amidah Repetition (Chazarat HaShatz)	א – תקנת חזרת הש"ץ
02 – Who May Fulfill His Obligation by Hearing the Amidah Repetition?	02. Who May Fulfill His Obligation by Hearing the Amidah Repetition?	ב – מי יכול לצאת ידי חובתו בשמיעת חזרת הש"ץ
03 – The Listener’s Conduct	03. The Listener's Conduct	ג – הנהגת השומעים
04 – Must Nine Men Respond to Chazarat HaShatz?	04. Must Nine Men Respond to Chazarat HaShatz?	ד – האם חובה שיהיו תשעה עונים לחזרת הש"ץ
05 – When Is the Amidah Repetition Not Recited?	05. When Is the Amidah Repetition Not Recited?	ה – מתי אין אומרים חזרת הש"ץ
06 – Kedushah	06. Kedushah	ו – קדושה
07 – When Does the Chazan Recite the Verses of Kedushah?	07. When Does the Chazan Recite the Verses of Kedushah?	ז – מתי יאמר החזן את פסוקי הקדושה
08 – Modim D’Rabbanan and Additional Laws	08. Modim D'Rabbanan and Additional Laws	ח – מודים דרבנן ועוד דינים
09 – Is It Possible to Make Up the Amidah Repetition?	09. Is It Possible to Make Up the Amidah Repetition?	ט – האם אפשר להשלים חזרת הש"ץ
20 - Birkat Kohanim – The Priestly Blessing	20. Birkat Kohanim. The Priestly Blessing	פרק כ - ברכת כהנים
01 – The Mitzvah of Birkat Kohanim	01. The Mitzvah of Birkat Kohanim	א – מצוות ברכת כהנים
02 – Yisrael’s Kavanah	02. Yisrael's Kavanah	ב – כוונת ישראל
03 – The Place Where the Congregation Stands	03. The Place Where the Congregation Stands	ג – מקום עמידת המתברכים
04 – Four Biblical Halachot	04. Four Biblical Halachot	ד – ארבע הלכות מהתורה
05 – The Connection of Birkat Kohanim to the Amidah and the Korbanot	05. The Connection of Birkat Kohanim to the Amidah and the Korbanot	ה – הקשר בין ברכת כהנים לתפילה ולקרבנות
06 – Washing Hands Before the Blessing	06. Washing Hands Before the Blessing	ו – נטילת ידיים לפני הברכה
07 – Yisrael’s Participation in Birkat Kohanim	07. Yisrael's Participation in Birkat Kohanim	ז – שותפות ישראל בברכת כהנים
08 – The Kohen’s Obligation to Remove His Shoes Before the Blessing	08. The Kohen's Obligation to Remove His Shoes Before the Blessing	ח – חובת חליצת הנעליים לפני הברכה
09 – The Role of the Kohanim	09. The Role of the Kohanim	ט – תפקיד הכהנים
10 – An Evil Kohen	10. An Evil Kohen	י – כהן רשע
11 – A Kohen Who Has Killed Is Ineligible to Ascend the Duchan	11. A Kohen Who Has Killed Is Ineligible to Ascend the Duchan	יא – כהן שהרג פסול לדוכן
21 - Nefillat Apayim and the Prayers of Supplication	21. Nefillat Apayim and the Prayers of Supplication	פרק כא - נפילת אפיים ותחנונים
01 – The Uniqueness of the Nefillat Apayim Prayer	01. The Uniqueness of the Nefillat Apayim Prayer	א – יחודה של תפילת נפילת אפיים
02 – The Custom of Its Recital	02. The Custom of Its Recital	ב – מנהג אמירתה
03 – What Is Nefillat Apayim?	03. What Is Nefillat Apayim?	ג – מהי נפילת אפיים
04 – How to Perform Nefillat Apayim	04. How to Perform Nefillat Apayim	ד – נפילת אפיים כיצד (לנוהגים ליפול)
05 – The Thirteen Attributes of Mercy	05. The Thirteen Attributes of Mercy	ה – י"ג מידות רחמים
06 – The Passages of Supplication and Nefillat Apayim	06. The Passages of Supplication and Nefillat Apayim	ו – סדר התחנונים ונפילת אפיים
07 – Days on Which Tachanun Is Not Recited	07. Days on Which Tachanun Is Not Recited	ז – ימים שאין אומרים בהם תחנון
08 – Chatan, Ba’alei Brit, and Other Ba’alei Simchah	08. Chatan, Ba'alei Brit, and Other Ba'alei Simchah	ח – חתן ובעלי ברית ובעלי שמחה אחרים
22 - Several Laws of Torah Reading	22. Several Laws of Torah Reading	פרק כב - מדיני קריאת התורה
01 – The Establishment of Torah Reading	01. The Establishment of Torah Reading	א – תקנת הקריאה בתורה
02 – The Torah Scroll	02. The Torah Scroll	ב – ספר התורה
03 – Taking Out the Torah and Returning It to the Ark	03. Taking Out the Torah and Returning It to the Ark	ג – הוצאת ספר התורה והחזרתו
04 – The Lifting of the Torah Scroll (Hagbahah) and Its Return to the Ark	04. The Lifting of the Torah Scroll (Hagbahah) and Its Return to the Ark	ד – הגבהה והחזרת הספר
05 – The Torah Reader	05. The Torah Reader	ה – הקורא
06 – The One Who Is Called Up and the Torah Blessings	06. The One Who Is Called Up and the Torah Blessings	ו – העולה וברכות התורה
07 – The Order of the People Called Up	07. The Order of the People Called Up	ז – סדר העולים
08 – The Congregation’s Conduct During Torah Reading	08. The Congregation's Conduct During Torah Reading	ח – התנהגות הציבור בעת הקריאה בתורה
09 – An Individual and a Congregation Who Did Not Hear the Torah Reading	09. An Individual and a Congregation Who Did Not Hear the Torah Reading	ט – דין יחיד וציבור שלא קראו בתורה
23 - The Conclusion of Shacharit and the Laws of Kaddish	23. The Conclusion of Shacharit and the Laws of Kaddish	פרק כג - סיום שחרית ודיני קדיש
01 – Ashrei and Lamenatze’ach	01. Ashrei and Lamenatze'ach	א – אשרי ולמנצח
02 – Kedushah D’Sidra – U’va L’Tzion	02. Kedushah D'Sidra. U'va L'Tzion	ב – קדושה דסדרא – ובא לציון
03 – A Person Who Is in a Hurry – When to Exit and What to Skip	03. A Person Who Is in a Hurry. When to Exit and What to Skip	ג -הממהר לצאת מהתפילה מתי יצא ועל מה ידלג
04 – Shir Shel Yom – Psalm of the Day	04. Shir Shel Yom. Psalm of the Day	ד – שיר של יום
05 – Pitum HaKetoret and Aleinu L’Shabe’ach	05. Pitum HaKetoret and Aleinu L'Shabe'ach	ה – פיטום הקטורת ועלינו לשבח
06 – The Kaddish and Its Virtue	06. The Kaddish and Its Virtue	ו – הקדיש ומעלתו
07 – The Various Kinds of Kaddish	07. The Various Kinds of Kaddish	ז – סוגי הקדיש
08 – The Order of the Kaddishim Recited at the End of the Prayer Service	08. The Order of the Kaddishim Recited at the End of the Prayer Service	ח – סדר הקדישים שבסיום התפילה
09 – Barchu	09. Barchu	ט – ברכו
10 – Is Another Kaddish Recited After Aleinu L’Shabe’ach?	10. Is Another Kaddish Recited After Aleinu L'Shabe'ach?	י – אם אומרים עוד קדיש אחר "עלינו לשבח"
11 – The Laws of Kaddish	11. The Laws of Kaddish	יא – דיני קדיש
12 – Kaddish After Learning	12. Kaddish After Learning	יב – קדיש אחר לימוד
24 - The Minchah Prayer	24. The Minchah Prayer	פרק כד - תפילת מנחה
01 – Its Objective	01. Its Objective	א – עניינה
02 – The Order of the Prayer	02. The Order of the Prayer	ב – סדר התפילה
03 – Minchah Time Corresponds to the Time of the Tamid Offering	03. Minchah Time Corresponds to the Time of the Tamid Offering	ג – זמנה כנגד זמן התמיד
04 – The Final Time to Recite Minchah	04. The Final Time to Recite Minchah	ד – סוף זמנה
05 – Forbidden Activities Before Minchah	05. Forbidden Activities Before Minchah	ה – דברים האסורים לפני מנחה
06 – A Meal Before Minchah	06. A Meal Before Minchah	ו – סעודה לפני תפילת מנחה
07 – Rabbi Yehudah’s Opinion	07. Rabbi Yehudah's Opinion	ז – דעת רבי יהודה
25 - The Ma’ariv Prayer	25. The Ma'ariv Prayer	פרק כה - תפילת מעריב
01 – Keriat Shema and Its Berachot	01. Keriat Shema and Its Berachot	א – קריאת שמע וברכותיה
02 – The Ma’ariv Amidah	02. The Ma'ariv Amidah	ב – תפילת עמידה של ערבית
03 – The Order of the Ma’ariv Prayer	03. The Order of the Ma'ariv Prayer	ג – סדר תפילת ערבית
04 – Adjoining Redemption to Prayer	04. Adjoining Redemption to Prayer	ד – סמיכת גאולה לתפילה
05 – The Time to Recite Keriat Shema Begins at Tzeit HaKochavim	05. The Time to Recite Keriat Shema Begins at Tzeit HaKochavim	ה – תחילת זמן קריאת שמע מצאת הכוכבים
06 – The Time of the Amidah According to the Chachamim and Rabbi Yehudah	06. The Time of the Amidah According to the Chachamim and Rabbi Yehudah	ו – תחילת זמן תפילה לחכמים ורבי יהודה
07 – The B’dieved Custom Linking Minchah to Ma’ariv Before Its Proper Time	07. The B'dieved Custom Linking Minchah to Ma'ariv Before Its Proper Time	ז – מנהג דיעבד בהצמדת מנחה למעריב לפני הזמן
08 – The Final Time to Recite Keriat Shema and the Amidah of Ma’ariv	08. The Final Time to Recite Keriat Shema and the Amidah of Ma'ariv	ח – סוף זמן קריאת שמע ותפילת ערבית
09 – Forbidden Activities Prior to Praying Ma’ariv	09. Forbidden Activities Prior to Praying Ma'ariv	ט – דברים האסורים לפני תפילת ערבית
26 - The Bedtime Shema	26. The Bedtime Shema	פרק כו - קריאת שמע על המיטה
01 – The Passages of the Bedtime Shema	01. The Passages of the Bedtime Shema	א – סדר קריאת שמע שעל המיטה
02 – The HaMapil Blessing	02. The HaMapil Blessing	ב – ברכת המפיל
03 – Additional Laws	03. Additional Laws	ג – דינים נוספים
06. The Fixed Formula (Nusaĥ)	06. The Fixed Formula (Nusah)	ו – הנוסח הקבוע
01. A Brief Outline of Women’s Obligation	01. A Brief Outline of Women's Obligation	א – מצוות הנשים בקיצור
02. According to Most Poskim Women Are Obligated to Pray Shaĥarit and Minĥa	02. According to Most Poskim Women Are Obligated to Pray Shaharit and Minha	ב – לרוב הפוסקים נשים חייבות בשחרית ומנחה
04. The Poskim Who Maintain that Women Fulfill Their Obligation with Birkhot Ha-shaĥar and Birkhot Ha-Torah	04. The Poskim Who Maintain that Women Fulfill Their Obligation with Birkhot Ha'shahar and Birkhot HaTorah	ד – הסוברים שיוצאות בברכות השחר והתורה
08. Are Women Permitted to Recite Blessings on Time-Bound Mitzvot?	08. Are Women Permitted to Recite Blessings on Time Bound Mitzvot?	ח – האם נשים רשאיות לברך על מצוות שהזמן גרמן
01. Men and Women – Mutually Complementary	01. Men and Women. Mutually Complementary	א – ההשלמה ההדדית שבין איש לאשה
02. Why Women Are Exempt from Positive Time-Bound Mitzvot	02. Why Women Are Exempt from Positive Time Bound Mitzvot	ב – טעם שנשים פטורות ממצוות עשה שהזמן גרמן
09. Women’s Prayer	09. Women's Prayer	ט – תפילת הנשים
02. Modesty (Tzni’ut)	02. Modesty (Tzni'ut)	ב – צניעות
02. Ru’aĥ Ra’ah (Evil Spirit)	02. Ru'ah Ra'ah (Evil Spirit)	ב – רוח-רעה
03. Ru’aĥ Ra’ah Today	03. Ru'ah Ra'ah Today	ג – רוח-רעה בזמננו
Chapter 06: Birkhot Ha-shaĥar – The Morning Blessings	Chapter 06. Birkhot Ha'shahar: The Morning Blessings	ו - ברכות השחר
02. She-asani Ki-rtzono – For Having Made Me According to His Will	02. She'asani Ki'rtzono. For Having Made Me According to His Will	ב – שעשני כרצונו
04. Birkhot Ha-shaĥar for One Who Does Not Derive Pleasure	04. Birkhot Ha'shahar for One Who Does Not Derive Pleasure	ד – ברכות השחר למי שלא נהנה
05. Until When May One Recite Birkhot Ha-shaĥar?	05. Until When May One Recite Birkhot Ha'shahar?	ה – עד מתי זמנן של ברכות השחר
06. The Time to Recite Birkhot Ha-shaĥar when Waking Up in the Middle of the Night	06. The Time to Recite Birkhot Ha'shahar when Waking Up in the Middle of the Night	ו – זמן ברכות השחר למי שקמה באמצע הלילה
Chapter 07: Birkhot Ha-Torah – The Blessings on the Torah	Chapter 07. Birkhot HaTorah: The Blessings on the Torah	ז - ברכות התורה
01. Women’s Connection to Torah	01. Women's Connection to Torah	א – שייכות הנשים לתורה
03. The Content of Birkhot Ha-Torah and Their Pertinence to Women	03. The Content of Birkhot HaTorah and Their Pertinence to Women	ג – תוכן ברכת התורה ושייכותה לנשים
04. The Value of Birkhot Ha-Torah	04. The Value of Birkhot HaTorah	ד – ערכה של ברכת התורה
05. Whether the Recitation of Birkhot Ha-Torah is a Biblical Mitzva and the Status of Birkat Ahavat Olam	05. Whether the Recitation of Birkhot HaTorah is a Biblical Mitzva and the Status of Birkat Ahavat Olam	ה – האם חיוב הברכה מהתורה ודין ברכת אהבת עולם
07. Birkhot Ha-Torah for the Whole Day	07. Birkhot HaTorah for the Whole Day	ז – ברכת התורה לכל היום
Chapter 08: The Shaĥarit Prayer and the Laws Prior to its Recitation	Chapter 08. The Shaharit Prayer and the Laws Prior to its Recitation	ח - תפילת שחרית והדינים שלפניה
01. The Time of Shaĥarit	01. The Time of Shaharit	א – זמן תפילת שחרית
03. Order of Preference in the Shaĥarit Service	03. Order of Preference in the Shaharit Service	ג – סדרי עדיפויות בתפילת שחרית
02. Preparing One’s Body for the Amida	02. Preparing One's Body for the Amida	ב – הכנת הגוף לתפילת עמידה
05. The Status of One Who Needs to Relieve Herself vis-à-vis Other Sacred Matters	05. The Status of One Who Needs to Relieve Herself vis a vis Other Sacred Matters	ה – דין הנצרכת לנקביה לשאר עניינים שבקדושה
08. What is the Law Be-di’avad?	05. The Status of One Who Needs to Relieve Herself vis a vis Other Sacred Matters	ח – מה הדין בדיעבד
11. The Prohibition of Reciting Sacred Words in the Presence of “Erva”	11. The Prohibition of Reciting Sacred Words in the Presence of "Erva"	Missing Section
03. Standing and Putting One’s Feet Together	03. Standing and Putting One's Feet Together	ג – עמידה ורגליים צמודות
10. The Status of Ĥutz La-aretz	10. The Status of Hutz La'aretz	י – דין חוץ לארץ
Chapter 15: Korbanot and Pesukei De-zimra	Chapter 15. Korbanot and Pesukei De'zimra	ט"ו - קרבנות ופסוקי דזמרה
01. Women’s Recitation of Korbanot: A Pious Custom	01. Women's Recitation of Korbanot: A Pious Custom	א – אמירת קרבנות לנשים מנהג חסידוּת
03. The Reason for the Recitation of Pesukei De-zimra	03. The Reason for the Recitation of Pesukei De'zimra	ג – טעם אמירת פסוקי דזמרה
04. Is the Recitation of Pesukei De-zimra Obligatory?	04. Is the Recitation of Pesukei De'zimra Obligatory?	ד – האם חובה לומר פסוקי דזמרה
05. What Are Pesukei De-zimra?	05. What Are Pesukei De'zimra?	ה – מהם פסוקי דזמרה
Chapter 16: Keri’at Shema and Its Berakhot	Chapter 16. Keri'at Shema and Its Berakhot	ט"ז - קריאת שמע וברכותיה
01. Women with Regard to the Mitzva of Keri’at Shema and Its Berakhot	01. Women with Regard to the Mitzva of Keri'at Shema and Its Berakhot	א – נשים במצוות קריאת שמע וברכותיה
12. The Berakhot Are an Extension of Keri’at Shema	12. The Berakhot Are an Extension of Keri'at Shema	יב – הברכות הן הרחבה של קריאת שמע
14. Interruption between Keri’at Shema and Its Berakhot	14. Interruption between Keri'at Shema and Its Berakhot	יד – הפסקה באמצע קריאת שמע וברכותיה
03. Reciting Taĥanun Today	03. Reciting Tahanun Today	ג – מנהג אמירת תחנונים כיום
05. The Taĥanun Passages	05. The Tahanun Passages	ה – סדר התחנונים
06. Ashrei, La-menatze’ach, and U-va Le-Tziyon	06. Ashrei, La'menatze'ach, and U'va LeTziyon	ו – אשרי למנצח ובא לציון
07. Shir shel Yom, Pitum Ha-ketoret, and Aleinu Le-shabe’aĥ	07. Shir shel Yom, Pitum Ha'ketoret, and Aleinu Le'shabe'ah	ז – שיר של יום, פיטום הקטורת ועלינו
Chapter 18: Minĥa and Ma’ariv	Chapter 18. Minha and Ma'ariv	י"ח - מנחה וערבית
01. The Time for Minĥa	01. The Time for Minha	א – זמן תפילת מנחה
02. Keri’at Shema of Ma’ariv and its Berakhot	02. Keri'at Shema of Ma'ariv and its Berakhot	ב – קריאת שמע וברכות של ערבית
03. The Ma’ariv Amida	03. The Ma'ariv Amida	ג – תפילת ערבית
02. Ha-mapil	02. Ha'mapil	ב – ברכת המפיל
01. Men’s Obligation to Pray with a Minyan and in a Synagogue	01. Men's Obligation to Pray with a Minyan and in a Synagogue	א – חיוב הגברים להתפלל במניין ובבית הכנסת
02 – Yisrael’s Kavanah	02. Yisrael's Kavanah	ב – נשים פטורות מתפילה בבית הכנסת ובמניין
06. Ĥazarat Ha-shatz	06. Hazarat Ha'shatz	ו – חזרת השץ (השליח ציבור)
07. Some Laws of Ĥazarat Ha-shatz and Responding “Amen”	07. Some Laws of Hazarat Ha'shatz and Responding "Amen"	ז – מדיני חזרת השץ ועניית אמן
16. The Ĥazan	16. The Hazan	טז – החזן
17. Ĥazanut for the Sake of Heaven	17. Hazanut for the Sake of Heaven	יז – חזנות לשם שמים
18. The Mourner’s Prayer and the Recitation of the Mourner’s Kaddish	18. The Mourner's Prayer and the Recitation of the Mourner's Kaddish	יח – תפילת האבלים ואמירת קדיש יתום
03. Va-yekhulu and Magen Avot	03. Va'yekhulu and Magen Avot	ג – ויכולו ומגן אבות
04. Pesukei De-zimra, Torah Reading, and Musaf	04. Pesukei De'zimra, Torah Reading, and Musaf	ד – פסוקי דזמרה, קריאת התורה ומוסף
01. Rosh Ĥodesh and Birkat Ha-levana	01. Rosh Hodesh and Birkat Ha'levana	א – ראש חודש וברכת הלבנה
04. “They too Participated in that Miracle” – Pesaĥ, Purim, and Ĥanuka	04. "They too Participated in that Miracle". Pesah, Purim, and Hanuka	ד – אף הן היו באותו הנס – פסח, פורים וחנוכה
5. Ĥanuka	5. Hanuka	ה – חנוכה
11. Birkat Ha-ilanot – The Blessing on the Trees	11. Birkat Ha'ilanot. The Blessing on the Trees	יא – ברכת האילנות
Chapter 24: Prayer Rites (Nusaĥ) and Customs of Different Communities	Chapter 24. Prayer Rites (Nusah) and Customs of Different Communities	כ"ד - נוסחי התפילה ומנהגי העדות
01. Differences in Nusaĥ	01. Differences in Nusah	א – שינויי הנוסחים
02. No Nusaĥ should be Considered Better than Another	02. No Nusah should be Considered Better than Another	ב – אין להחשיב נוסח אחד כעדיף מחבירו
05. In What Cases may one Change her Nusaĥ?	05. In What Cases may one Change her Nusah?	ה – באיזה מקרים מותר לשנות את הנוסח
1-The Meaning of the Holiday	1. The Meaning of the Holiday	א - משמעות החג
1. The Festival of Matzot and the Festival of Pesaĥ	1. The Festival of Matzot and the Festival of Pesah	א – חג המצות וחג הפסח
2. The Festival of Freedom – the Revelation of Morality	2. The Festival of Freedom. the Revelation of Morality	ב – חג החירות – גילוי המוסר
3. Spiritual liberation from Material Enslavement	3. Spiritual liberation from Material Enslavement	ג – יציאת מצרים – שחרור הרוח משעבוד החומר
4. At the Exodus, the Material World Became a Vehicle for God’s Shekhina	4. At the Exodus, the Material World Became a Vehicle for God's Shekhina	ד – ביציאת מצרים נעשה החומר מרכבה לשכינה
5. The Meaning of the Prohibition against Ĥametz – Pride in Relation to God	5. The Meaning of the Prohibition against Hametz. Pride in Relation to God	ה – משמעות איסור חמץ – גאווה כלפי שמיים
8. One Inquires about the Laws of Pesaĥ Beginning Thirty Days before Pesaĥ	8. One Inquires about the Laws of Pesah Beginning Thirty Days before Pesah	ח – שואלים בהלכות הפסח קודם לפסח שלושים יום
2 - General Rules of the Prohibition against Ĥametz	2. General Rules of the Prohibition against Hametz	ב - כללי איסור חמץ
1. Four Mitzvot Concerning the Prohibition against Ĥametz	1. Four Mitzvot Concerning the Prohibition against Hametz	א – ארבע מצוות באיסור חמץ
2. The Times When Ĥametz Is Prohibited by Torah Law and by Rabbinic Law	2. The Times When Hametz Is Prohibited by Torah Law and by Rabbinic Law	ב – זמני איסור חמץ מהתורה ומדברי חכמים
3. What Is Ĥametz and What Is Se’or?	3. What Is Hametz and What Is Se'or?	ג – מהו חמץ ומהו שאור
5. Ĥametz Nuksheh (Hardened Ĥametz)	5. Hametz Nuksheh (Hardened Hametz)	ה – חמץ נוקשה
6. Ĥametz So Spoiled That a Dog Would Not Eat It	6. Hametz So Spoiled That a Dog Would Not Eat It	ו – חמץ שנפסל ממאכל כלב
3 - The Mitzva of Getting Rid of Ĥametz	3. The Mitzva of Getting Rid of Hametz	ג - מצוות השבתת החמץ
1. The Mitzvot Associated with Getting Rid of Ĥametz	1. The Mitzvot Associated with Getting Rid of Hametz	א – המצוות הקשורות בהשבתת חמץ
2. The Prohibition against Ĥametz One Owns	2. The Prohibition against Hametz One Owns	ב – האיסור על חמץ השייך לו
3. Ĥametz That Has Been Guaranteed by a Jew and the Status of Stocks	3. Hametz That Has Been Guaranteed by a Jew and the Status of Stocks	ג – חמץ שבאחריות ישראל ודין מניות
4. How One Fulfills the Mitzva of Removing the Ĥametz	4. How One Fulfills the Mitzva of Removing the Hametz	ד – כיצד מקיימים את מצוות השבתת החמץ
5. The Essence of the Mitzva	5. The Essence of the Mitzva	ה – מהות המצווה
6. When the Prohibitions of Eating and Benefiting from Ĥametz Begin	6. When the Prohibitions of Eating and Benefiting from Hametz Begin	ו – זמני כניסת איסור אכילה והנאה מחמץ
7. The Procedure for Getting Rid of Ĥametz	7. The Procedure for Getting Rid of Hametz	ז – סדר השבתת החמץ
4 - Bedikat Ĥametz – the Search for Ĥametz	4. Bedikat Hametz. the Search for Hametz	ד - בדיקת חמץ
1. The Time for Bedikat Ĥametz	1. The Time for Bedikat Hametz	א – זמן בדיקת חמץ בתחילת ליל י"ד
2. Activities Rabbinically Forbidden before Bedikat Ĥametz	2. Activities Rabbinically Forbidden before Bedikat Hametz	ב – דברים שאסרו חכמים קודם הבדיקה
3. The Berakha	3. The Berakha	ג – הברכה
4. Places That Must Be Searched	4. Places That Must Be Searched	ד – מקומות החייבים בבדיקה
5. The Candle and the Flashlight	5. The Candle and the Flashlight	ה – הנר ופנס
6. Must One Search for Less than a Kezayit of Ĥametz?	6. Must One Search for Less than a Kezayit of Hametz?	ו – האם צריך לבדוק אחר פירורים קטנים מכזית
7. Do Books Require Bedikat Ĥametz?	7. Do Books Require Bedikat Hametz?	ז – האם צריך לבדוק את הספרים
8. Do We Rely upon the Cleaning Done before Pesaĥ?	8. Do We Rely upon the Cleaning Done before Pesah?	ח – האם סומכים על הניקוי שלפני פסח
9. Hiding Pieces of Bread and Receiving Help from Family Members	9. Hiding Pieces of Bread and Receiving Help from Family Members	ט – הנחת פתיתי חמץ והאפשרות להעזר בבני ביתו
10. One Who Travels	10. One Who Travels	י – היוצא למדינת הים
11. Does Renting One’s Entire House to a Gentile Exempt It from Bedikat Ĥametz?	11. Does Renting One's Entire House to a Gentile Exempt It from Bedikat Hametz?	י"א – אם השכרת כל הבית לגוי פוטרתו מבדיקה
12. Bedikat Ĥametz after the Proper Time and the Status of One Who Rents a Hotel Room	12. Bedikat Hametz after the Proper Time and the Status of One Who Rents a Hotel Room	י"ב – בדיקת חמץ אחר זמנה, ודין השוכר חדר במלון
13. Synagogue, Dormitory, and Yeshiva	13. Synagogue, Dormitory, and Yeshiva	י"ג – בית כנסת, פנימיות וישיבות
14. Ĥametz Buried under a Pile of Dirt and the Question of Searching a Storeroom	14. Hametz Buried under a Pile of Dirt and the Question of Searching a Storeroom	י"ד – חמץ תחת מפולת ואם צריך לבדוק מחסן
5 - Bitul and Bi’ur Ĥametz	5. Bitul and Bi'ur Hametz	ה - ביטול חמץ וביעורו
1. Bitul Ĥametz in the Evening and Morning	1. Bitul Hametz in the Evening and Morning	א – ביטול החמץ בלילה וביום
2. The Significance of Bitul Ĥametz	2. The Significance of Bitul Hametz	ב – משמעות ביטול החמץ
3. Laws Regarding Bitul Ĥametz	3. Laws Regarding Bitul Hametz	ג – דיני ביטול החמץ
4. The Custom of Bi’ur Ĥametz by Burning	4. The Custom of Bi'ur Hametz by Burning	ד – מנהג ביעור החמץ בשריפה
5. Ĥametz in the Garbage	5. Hametz in the Garbage	ה – חמץ שבאשפה
6. Ĥametz Found after the Onset of the Prohibition	6. Hametz Found after the Onset of the Prohibition	ו – חמץ שנמצא אחר תחילת זמן האיסור
6 - Mekhirat Ĥametz – the Sale of Ĥametz	6. Mekhirat Hametz. the Sale of Hametz	ו - מכירת חמץ
1. Sparing Ĥametz from Destruction by Selling It to a Gentile	1. Sparing Hametz from Destruction by Selling It to a Gentile	א – הצלת החמץ מאיבוד על ידי מכירתו לגוי
2. How the Practice of Selling Ĥametz Spread	2. How the Practice of Selling Hametz Spread	ב – התפשטות מנהג מכירת החמץ
3. For Whom Is the Ĥametz Sale Intended Today?	3. For Whom Is the Hametz Sale Intended Today?	ג – למי נועדה כיום מכירת חמץ
4. The Laws of the Sale	4. The Laws of the Sale	ד – דיני המכירה
5. The Deadline for Selling Ĥametz and the Status of One Visiting Israel or Abroad	5. The Deadline for Selling Hametz and the Status of One Visiting Israel or Abroad	ה – סוף זמן מכירה ודין בן חו"ל
6. Ĥametz That Was Sold – Its Status after Pesaĥ	6. Hametz That Was Sold. Its Status after Pesah	ו – החמץ שנמכר – דינו אחר הפסח
7 - Ĥametz Mixtures	7. Hametz Mixtures	ז - תערובת חמץ
1. Even a Drop of Ĥametz Renders Food Forbidden	1. Even a Drop of Hametz Renders Food Forbidden	א – חמץ בפסח אוסר את תערובתו בכלשהו
2. Can a Mixture Containing a Drop of Ĥametz Be Salvaged?	2. Can a Mixture Containing a Drop of Hametz Be Salvaged?	ב – האם אפשר להציל תערובת שיש בה כלשהו חמץ
3. Can Ĥametz That Was Nullified before Pesaĥ Regain Its Status (“Ĥozer Ve-ne’or”) on Pesaĥ?	3. Can Hametz That Was Nullified before Pesah Regain Its Status ("Hozer Ve'ne'or") on Pesah?	ג – האם חמץ שנתבטל לפני פסח "חוזר וניעור" בפסח
4. Ĥozer Ve-ne’or in Practice	4. Hozer Ve'ne'or in Practice	ד – הלכה למעשה בדין "חוזר וניעור"
5. Does Ĥametz That Imparts Foul Taste (“Noten Ta’am Li-fgam”) Render a Mixture Forbidden?	5. Does Hametz That Imparts Foul Taste ("Noten Ta'am Li'fgam") Render a Mixture Forbidden?	ה – האם חמץ שנותן טעם פגום אוסר תערובתו
6. The Torah Law Concerning Ĥametz Mixtures	6. The Torah Law Concerning Hametz Mixtures	ו – דין אכילת תערובת חמץ והשהייתה בפסח
8 - Pesaĥ Kashrut	8. Pesah Kashrut	ח - מהלכות כשרות לפסח
1. Matza Ashira (“Egg Matza”)	1. Matza Ashira ("Egg Matza")	א – מצה עשירה – לישה במי פירות
2. Becoming Ĥametz Once It Has Been Baked, and the Status of Matza Sheruya (Soaked Matza; “Gebrokts”)	2. Becoming Hametz Once It Has Been Baked, and the Status of Matza Sheruya (Soaked Matza; "Gebrokts")	ב – אין החמצה אחר אפיה, ודין מצה שרויה
3. Sephardic and Ashkenazic Approaches to Keeping Kosher on Pesaĥ	3. Sephardic and Ashkenazic Approaches to Keeping Kosher on Pesah	ג – כללי כשרות לפסח, שיטת הספרדים והאשכנזים
4. Principles of Kosher Supervision on Pesaĥ	4. Principles of Kosher Supervision on Pesah	ד – כללי ההשגחה לפסח
5. Milk from an Animal That Ate Ĥametz	5. Milk from an Animal That Ate Hametz	ה – חלב מבהמה שאוכלת חמץ
6. Meat and Eggs	6. Meat and Eggs	ו – בשר וביצים
7. Medicines on Pesaĥ	7. Medicines on Pesah	ז – תרופות בפסח
8. Citric Acid	8. Citric Acid	ח – חומצת לימון
9. Soaps and Cosmetics	9. Soaps and Cosmetics	ט – סבונים וקוסמטיקה
9 - Kitniyot	9. Kitniyot	ט - מנהג איסור קטניות
1. The Origins of the Ashkenazic Custom	1. The Origins of the Ashkenazic Custom	א – שורשי מנהג אשכנז
2. The Sephardic Custom	2. The Sephardic Custom	ב – מנהג הספרדים בקטניות ובאורז
3. Spouses from Different Communities	3. Spouses from Different Communities	ג – בני זוג מעדות שונות
4. Prohibited Species	4. Prohibited Species	ד – המינים הכלולים באיסור
5. Rules Governing This Custom	5. Rules Governing This Custom	ה – דיני המנהג
6. Kitniyot That Never Touched Water and Kitniyot Oils	6. Kitniyot That Never Touched Water and Kitniyot Oils	ו – קטניות שלא נגעו במים, ושמני קטניות
7. Extenuating Circumstances, the Sick, and Babies	7. Extenuating Circumstances, the Sick, and Babies	ז – בשעת הצורך לחולים וקטנים
10 - The Principles of Hagalat Kelim	10. The Principles of Hagalat Kelim	י - כללי הגעלת כלים
1. When Does Taste Absorbed into Utensils Render Their Contents Forbidden?	1. When Does Taste Absorbed into Utensils Render Their Contents Forbidden?	א – דין הטעם הבלוע בכלים, מתי אוסר?
2. Ĥametz Utensils on Pesaĥ	2. Hametz Utensils on Pesah	ב – דין כלי חמץ בפסח
3. Releasing through the Same Method as Absorption (“Ke-bole’o Kakh Polto”): Hagala and Heavy Libun	3. Releasing through the Same Method as Absorption ("Ke'bole'o Kakh Polto"): Hagala and Heavy Libun	ג – כבולעו כך פולטו – הגעלה וליבון חמור
4. Defining the Difference between Absorption through Liquid and Absorption through Fire: the Status of a Frying Pan	4. Defining the Difference between Absorption through Liquid and Absorption through Fire: The Status of a Frying Pan	ד – גדר ההבדל בין בליעה באור לנוזלים, ודין מחבת
5. Heavy and Light Libun: Does Temperature Affect Absorption?	5. Heavy and Light Libun: Does Temperature Affect Absorption?	ה – ליבון חמור וליבון קל (האם מתחשבים ברמת החום בבליעה)
6. Koshering Vessels That Absorbed Ĥametz Prior to the Onset of the Prohibition	6. Koshering Vessels That Absorbed Hametz Prior to the Onset of the Prohibition	ו – היתרא בלע – הכשרה לפסח
7. Utensils Likely to Be Damaged by Libun; Baking Trays	7. Utensils Likely to Be Damaged by Libun; Baking Trays	ז – כלים שעלולים להינזק בליבון ודין תבניות
8. The Principles of Hagala	8. The Principles of Hagala	ח – כללי ההגעלה
9. What Determines the Type of Hagala: Main Use or Most Intense Absorption?	9. What Determines the Type of Hagala: Main Use or Most Intense Absorption?	ט – אם הולכים אחר הבליעה החמורה או רוב תשמישו
10. Cleaning and Preparing Utensils for Hagala	10. Cleaning and Preparing Utensils for Hagala	י – ניקוי הכלים והכנתם להגעלה
11. The Reason to Wait Twenty-Four Hours before Hagala	11. The Reason to Wait Twenty Four Hours before Hagala	י"א – טעם ההמתנה עשרים וארבע שעות לפני ההגעלה
12. Hagala in Practice	12. Hagala in Practice	י"ב – הגעלת הכלים בפועל
13. Koshering Pots via Hagala	13. Koshering Pots via Hagala	י"ג – הגעלת סירים
14. Absorption through Pickling (“Kvisha”) and Its Koshering	14. Absorption through Pickling ("Kvisha") and Its Koshering	י"ד – בליעה בכבוש והכשרתו
11 - Koshering the Kitchen	11. Koshering the Kitchen	י"א - הכשרת המטבח לפסח
1. Countertops	1. Countertops	א – שיש
2. The Sink	2. The Sink	ב – כיור
3. Grates, Burners, and Stovetops	3. Grates, Burners, and Stovetops	ג – חצובה של כיריים גז, כיריים חשמליות וקרמיות
4. Ovens	4. Ovens	ד – תנור אפייה
5. Warming Trays (Shabbat “Plata”s)	5. Warming Trays (Shabbat "Plata"s)	ה – פלטה של שבת
6. Microwave Ovens	6. Microwave Ovens	ו – מיקרו גל
7. Dishwashers	7. Dishwashers	ז – מדיח כלים
8. The Dining Table	8. The Dining Table	ח – שולחן האוכל
9. The Refrigerator and Kitchen Cabinets	9. The Refrigerator and Kitchen Cabinets	ט – מקרר וארונות מטבח
10. Pots, Skillets, Silverware, and (Non-Earthenware) Bowls	10. Pots, Skillets, Silverware, and (Non Earthenware) Bowls	י – סירים מחבתות קערות (שאינן מחרס) וסכו"ם
11. Blenders and Mixers	11. Blenders and Mixers	י"א – בלנדר ומיקסר
12. Other Utensils	12. Other Utensils	י"ב – כלים שונים
13. Earthenware and Porcelain Utensils	13. Earthenware and Porcelain Utensils	י"ג – כלי חרס ופורצלאן
14. Glassware	14. Glassware	י"ד – כלי זכוכית
15. Enamel Utensils	15. Enamel Utensils	ט"ו – כלי אמייל
16. Plastic Utensils	16. Plastic Utensils	ט"ז – כלי פלסטיק
12 - The Laws of Matza	12. The Laws of Matza	י"ב - הלכות מצה
1. The Mitzva of Eating Matza	1. The Mitzva of Eating Matza	א – מצוות אכילת מצה
2. Shmura Matza	2. Shmura Matza	ב – מצה שמורה
3. Does the Guarding Have to Be with the Intent to Fulfill a Mitzva?	3. Does the Guarding Have to Be with the Intent to Fulfill a Mitzva?	ג – האם השמירה צריכה כוונה לשם מצווה
4. Handmade versus Machine-Made Matza at the Seder	4. Handmade versus Machine Made Matza at the Seder	ד – כשרות מצות יד ומצות מכונה למצוות אכילת מצה
5. Is There Value in Eating Handmade Matzot All Pesaĥ?	5. Is There Value in Eating Handmade Matzot All Pesah?	ה – האם ראוי לאכול בכל הפסח מצות שמורות
6. Water That Has Stayed Overnight	6. Water That Has Stayed Overnight	ו – מים שלנו
7. Preventing Leavening during Kneading	7. Preventing Leavening during Kneading	ז – שמירה מחימוץ בעת הלישה
8. More Laws about Matza	8. More Laws about Matza	ח – דינים נוספים במצות
13 - The Laws and Customs of Erev Pesaĥ	13. The Laws and Customs of Erev Pesah	י"ג - הלכות ערב פסח ומנהגיו
1. The Prohibition against Work (Melakha) on Erev Pesaĥ	1. The Prohibition against Work (Melakha) on Erev Pesah	א – איסור עשיית מלאכה בערב פסח
2. Which Melakhot Are Forbidden?	2. Which Melakhot Are Forbidden?	ב – איזו מלאכה אסורה
3. Ta’anit Bekhorot – the Fast of the Firstborns	3. Ta'anit Bekhorot. the Fast of the Firstborns	ג – תענית בכורות
4. Who Is Included in the Custom to Fast?	4. Who Is Included in the Custom to Fast?	ד – על מי מנהג הצום
5. The Custom to Rely on a Siyum Masekhet	5. The Custom to Rely on a Siyum Masekhet	ה – המנהג לסמוך על סיום מסכת
6. The Prohibition on Eating Matza on Erev Pesaĥ	6. The Prohibition on Eating Matza on Erev Pesah	ו – איסור אכילת מצה ביום י"ד
7. Summary: What Can Be Eaten on Erev Pesaĥ	7. Summary: What Can Be Eaten on Erev Pesah	ז – סיכום המאכלים שמותר לאכול בערב פסח
8. Baking Matza and Reciting Seder Korban Pesaĥ	8. Baking Matza and Reciting Seder Korban Pesah	ח – אפיית מצות ואמירת קרבן פסח
14 - When Erev Pesaĥ Falls on Shabbat	14. When Erev Pesah Falls on Shabbat	י"ד - ערב פסח שחל בשבת
1. Bi’ur Ĥametz and Shabbat Meals	1. Bi'ur Hametz and Shabbat Meals	א – סדר ביעור החמץ ושלוש הסעודות
2. Additional Laws	2. Additional Laws	ב – עוד דינים
15 - The Hagada	15. The Hagada	ט"ו - ההגדה
1. “Tell your Child”	1. "Tell your Child"	א – והגדת לבנך
2. The Mitzva to Tell the Exodus Story on Pesaĥ Night	2. The Mitzva to Tell the Exodus Story on Pesah Night	ב – המצווה לספר ביציאת מצרים בליל פסח
3. The Mitzva to Begin the Seder with a Question	3. The Mitzva to Begin the Seder with a Question	ג – המצווה לפתוח את הסדר בשאלה
4. The Text of “Ma Nishtana”	4. The Text of "Ma Nishtana"	ד – נוסח "מה נשתנה"
5. The Torah Speaks of Four Children	5. The Torah Speaks of Four Children	ה – כנגד ארבעה בנים דברה תורה
6. The Main Message of the Hagada	6. The Main Message of the Hagada	ו – המסר המרכזי של ההגדה
7. From Indignity to Praise	7. From Indignity to Praise	ז – פותחים בגנות ומסיימים בשבח
8. The Meaning of the Ten Plagues	8. The Meaning of the Ten Plagues	ח – משמעות עשר המכות
9. Pesaĥ, Matza, and Maror	9. Pesah, Matza, and Maror	ט – פסח מצה ומרור
16 - Seder Night	16. Seder Night	ט"ז - ליל הסדר
1. Introduction	1. Introduction	א – הקדמה
2. Preparing for the Seder	2. Preparing for the Seder	ב – ההכנות לסדר
3. The Seder Plate	3. The Seder Plate	ג – הקערה
4. Arranging the Seder Plate	4. Arranging the Seder Plate	ד – סידור הקערה
5. Kadesh – Kiddush	5. Kadesh. Kiddush	ה – קדש – קידוש
6. The Four Cups	6. The Four Cups	ו – ארבע כוסות
7. The Wine	7. The Wine	ז – היין
8. The Amount of Wine and Cup Size	8. The Amount of Wine and Cup Size	ח – שיעור היין והכוס
9. How Much Wine?	9. How Much Wine?	ט – שיעור השתייה
10. The Mitzva of Reclining	10. The Mitzva of Reclining	י – מצוות הסבה
11. How to Recline	11. How to Recline	י"א – כיצד מסבים
12. If One Forgets To Recline	12. If One Forgets To Recline	י"ב – דין מי ששכח להסב
13. May One Drink after the First Cup?	13. May One Drink after the First Cup?	י"ג – האם מותר לאכול או לשתות אחר כוס ראשונה?
14. Raĥatz – Washing Hands before Eating Karpas	14. Rahatz. Washing Hands before Eating Karpas	י"ד – רחץ – נטילת ידיים לפני אכילת הכרפס
15. Karpas	15. Karpas	ט"ו – כרפס
16. Yaĥatz – Breaking the Middle Matza	16. Yahatz. Breaking the Middle Matza	ט"ז – יחץ – חציית המצה האמצעית
17. Magid – Beginning the Hagada	17. Magid. Beginning the Hagada	י"ז – מגיד – פתיחת ההגדה
18. Laws of Reciting the Hagada	18. Laws of Reciting the Hagada	י"ח – דיני אמירת ההגדה
19. Customs Regarding the Recitation of the Hagada	19. Customs Regarding the Recitation of the Hagada	י"ט – מנהגי אמירת ההגדה
20. The Mitzva to Recite Hallel on the Seder Night	20. The Mitzva to Recite Hallel on the Seder Night	כ – מצוות אמירת ההלל בליל הסדר
21. The Laws of the Second and Fourth Cups	21. The Laws of the Second and Fourth Cups	כא – כוס שנייה – לשו"ע לא יברך ולרמ"א יברך
22. The Mitzva to Eat Matza	22. The Mitzva to Eat Matza	כ"ב – מצוות אכילת מצה
23. Calculating the Size of a Kezayit for Torah Commandments	23. Calculating the Size of a Kezayit for Torah Commandments	כ"ג – חשבון שיעור כזית לקיום המצווה מהתורה
24. The Sephardic Custom Regarding a Kezayit	24. The Sephardic Custom Regarding a Kezayit	כ"ד – מנהג ספרדים בשיעור כזית
25. How Much Is a Shi’ur Akhilat Pras?	25. How Much Is a Shi'ur Akhilat Pras?	כ"ה – שיעור אכילת פרס
26. How the Matza Is Eaten	26. How the Matza Is Eaten	כ"ו – סדר אכילת המצה
27. The Mitzva to Eat Maror	27. The Mitzva to Eat Maror	כ"ז – מצוות אכילת מרור
28. Korekh	28. Korekh	כ"ח – כורך
29. Those Who Have Difficulty Eating Matza	29. Those Who Have Difficulty Eating Matza	כ"ט – המתקשים לאכול שיעורי המצות
30. Those Exempt from Matza and Maror	30. Those Exempt from Matza and Maror	ל – איזה חולה פטור מאכילת מצה ומרור
31. The Time for Eating the Matza, Maror, and Afikoman	31. The Time for Eating the Matza, Maror, and Afikoman	ל"א – זמן אכילת המצה המרור והאפיקומן
32. Meal Customs: Roasted Foods, Eggs	32. Meal Customs: Roasted Foods, Eggs	ל"ב – מנהגי הסעודה – צלי, ביצים
33. Tzafun – the Afikoman	33. Tzafun. the Afikoman	ל"ג – צפון – אפיקומן
34. The Afikoman: Two Reasons, Two Kezeytim	34. The Afikoman: Two Reasons, Two Kezeytim	ל"ד – שני טעמים לאכילת האפיקומן – שני זיתים.
35. Hallel, the Great Hallel, and the Concluding Berakha	35. Hallel, the Great Hallel, and the Concluding Berakha	ל"ה – אמירת הלל והלל הגדול וברכת השיר
36. The Fifth Cup – Eliyahu’s Cup	36. The Fifth Cup. Eliyahu's Cup	ל"ו – כוס חמישית – כוס של אליהו
37. Drinking Coffee or Juice after the Seder	37. Drinking Coffee or Juice after the Seder	ל"ז – האם מותר לשתות קפה או מיץ אחר סיום הסדר?
38. Recounting the Exodus and Studying the Laws of Pesaĥ All Night	38. Recounting the Exodus and Studying the Laws of Pesah All Night	ל"ח – מצווה לספר וללמוד את ההלכות כל הלילה
01 - Rosh Ĥodesh	01. Rosh Hodesh	א - ראש חודש
1 – The Jewish Month	1. The Jewish Month	א – החודש העברי
2 – The Authority to Fix the Months was Entrusted to Israel	2. The Authority to Fix the Months was Entrusted to Israel	ב – הסמכות לקביעת החודשים ניתנה לישראל
3 – The History of the Sanctification of the Moon	3. The History of the Sanctification of the Moon	ג – תולדות קידוש החודשים
4 – Rosh Chodesh – One Day or Two?	4. Rosh Chodesh. One Day or Two?	ד – אימתי ראש חודש יום אחד ואימתי יומיים
5 – The Status of Rosh Chodesh in the Torah	5. The Status of Rosh Chodesh in the Torah	ה – מעמדו של ראש חודש בתורה
6 – Festive Meals on Rosh Chodesh and the Prohibition to Fast or Grieve	6. Festive Meals on Rosh Chodesh and the Prohibition to Fast or Grieve	ו – שמחה וסעודת ראש חודש ואיסור תענית וצער
7 – The Custom of Women Refraining from Work on Rosh Chodesh	7. The Custom of Women Refraining from Work on Rosh Chodesh	ז – מנהג נשים בהימנעות ממלאכה בראש חודש
8 – Shabbat Mevarchim (Blessing the New Month)	8. Shabbat Mevarchim (Blessing the New Month)	ח – שבת מברכים
2 - The Laws of Counting the Omer	2. The Laws of Counting the Omer	ב - הלכות ספירת העומר
1 – The Mitzvah and its Meaning	1. The Mitzvah and its Meaning	א – מצוות הספירה ומשמעותה
2 – The Process of Ascension from Nationalism to Spirituality	2. The Process of Ascension from Nationalism to Spirituality	ב – תהליך העלייה מהלאומיות לרוחניות
3 – The Mechanics of Counting	3. The Mechanics of Counting	ג – נוסח הספירה
4 – The Status of the Mitzvah after the Temple’s Destruction	4. The Status of the Mitzvah after the Temple's Destruction	ד – מעמד המצווה לאחר החורבן
5 – When to Count	5. When to Count	ה – זמן הספירה
6 – Until When Can One Count?	6. Until When Can One Count?	ו – עד מתי אפשר לספור
7 – One Who forgets to Count an Entire Day	7. One Who forgets to Count an Entire Day	ז – דין השוכח לספור יום אחד
8 – When in Doubt, Continue Counting with a Blessing	8. When in Doubt, Continue Counting with a Blessing	ח – בכל הספקות ממשיך לספור בברכה
9 – Women and the Omer Count	9. Women and the Omer Count	ט – נשים בספירת העומר
10 – Specific Laws Regarding the Mitzvah of Counting	10. Specific Laws Regarding the Mitzvah of Counting	י – פרטי דינים במצוות הספירה
3 - Customs of Mourning During the Omer Period	3. Customs of Mourning During the Omer Period	ג - מנהגי אבלות בספירת העומר
1 – The Reason for These Customs	1. The Reason for These Customs	א – טעם מנהגי האבלות שבספירת העומר
2 – The Duration of the Mourning Period	2. The Duration of the Mourning Period	ב – זמני מנהגי האבלות
3 – The Sefardi Practice	3. The Sefardi Practice	ג – מנהג יוצאי ספרד
4 – The Ashkenazi Practice	4. The Ashkenazi Practice	ד – מנהג יוצאי אשכנז
5 – Weddings and Engagements During the Omer Peeriod	5. Weddings and Engagements During the Omer Peeriod	ה – נישואין ואירוסין בימי ספירת העומר
6 – Haircuts	6. Haircuts	ו – תספורת
7 – Shaving	7. Shaving	ז – גילוח
8 – Dancing and Musical Instruments	8. Dancing and Musical Instruments	ח – ריקודים וכלי זמר
9 – Circumcisions, Torah Processions, and Bar Mitzvahs	9. Circumcisions, Torah Processions, and Bar Mitzvahs	ט – ברית מילה, הכנסת ספר תורה ובר מצווה
10 – Listening to Music on Electronic Devices	10. Listening to Music on Electronic Devices	י – שמיעת מוזיקה ממכשיר חשמל ביתי
11 – SheHechiyanu	11. SheHechiyanu	יא – שהחיינו
12 – Brief Summary of the Joyous Days of the Omer Period	12. Brief Summary of the Joyous Days of the Omer Period	יב – סיכום קצר לימי שמחה שבתוך ספירת העומר
4 - Yom HaAtzmaut, Yom Yerushalayim, Yom HaZikaron	4. Yom HaAtzmaut, Yom Yerushalayim, Yom HaZikaron	ד - יום העצמאות
1 – The Mitzvah of Settling the Land of Israel	1. The Mitzvah of Settling the Land of Israel	א – מצוות ישוב הארץ
2 – The Beginning of Redemption and Sanctifying God’s Name	2. The Beginning of Redemption and Sanctifying God's Name	ב – אתחלתא דגאולה וקידוש ה'
3 – Salvation of Israel	3. Salvation of Israel	ג – הצלת ישראל
4 – The Three Oaths	4. The Three Oaths	ד – שלוש השבועות
5 – Establishing Yom HaAtzmaut as a Lasting Holiday	5. Establishing Yom HaAtzmaut as a Lasting Holiday	ה – קביעת יום טוב לדורות ביום העצמאות
6 – The Recitation of Hallel	6. The Recitation of Hallel	ו – אמירת הלל
7 – Hallel With or Without a Blessing?	7. Hallel With or Without a Blessing?	ז – האם לומר הלל בברכה
8 – SheHechiyanu and Hallel at Night	8. SheHechiyanu and Hallel at Night	ח – שהחיינו והלל בלילה
9 – The Different Dates of Yom HaAtzmaut	9. The Different Dates of Yom HaAtzmaut	ט – ברוב המקרים יום העצמאות נדחה
10 – Yom Yerushalayim	10. Yom Yerushalayim	י – יום ירושלים
11 – Shaving, Haircuts, Weddings, and Tachanun	11. Shaving, Haircuts, Weddings, and Tachanun	יא – גילוח, תספורת, נישואין ותחנון
12 – Yom HaZikaron (Memorial Day) for the Fallen Soldiers of Tzahal	12. Yom HaZikaron (Memorial Day) for the Fallen Soldiers of Tzahal	יב – יום הזיכרון לחיילי צה"ל
13 – The Siren and Standing Silently on Yom HaZikaron	13. The Siren and Standing Silently on Yom HaZikaron	יג – צפירה ודומיה ביום הזיכרון לחללי צה"ל
14 – Holocaust Remembrance Day	14. Holocaust Remembrance Day	יד – יום הזיכרון לשואה ולגבורה
5 - Lag B’Omer	5. Lag B'Omer	ה - ל"ג בעומר
01 – The Thirty-Third Day of the Omer	01. The Thirty Third Day of the Omer	א – ל"ג בעומר
02 – The Hillula of R. Shimon bar Yochai (“Rashbi”)	02. The Hillula of R. Shimon bar Yochai ("Rashbi")	ב – הילולת רשב"י
03 – R. Shimon bar Yochai’s Character	03. R. Shimon bar Yochai's Character	ג – אישיותו של רשב"י
04 – Rabbi Akiva	04. Rabbi Akiva	ד – רבי עקיבא
05 – Bonfires on Lag B’Omer	05. Bonfires on Lag B'Omer	ה – מדורות ושמחת ל"ג בעומר
06 – The Chalekah or Upsherin Custom: Cutting the Hair of Young Boys	06. The Chalekah or Upsherin Custom: Cutting the Hair of Young Boys	ו – מנהג תספורת הקטנים – 'חלקה'
07 – Throwing Clothes into the Fire and Praying at the Gravesites of Tzaddikim	07. Throwing Clothes into the Fire and Praying at the Gravesites of Tzaddikim	ז – השלכת בגדים למדורה ותפילה ליד קברי צדיקים
6 - The Four Fasts Commemorating the Churban	6. The Four Fasts Commemorating the Churban	ו - ארבעת צומות החורבן
1 – Instituting the Fasts	1. Instituting the Fasts	א – תקנת הצומות
2 – The Tenth of Tevet	2. The Tenth of Tevet	ב – עשרה בטבת
3 – The Seventeenth of Tammuz	3. The Seventeenth of Tammuz	ג – שבעה עשר בתמוז
4 – The Ninth of Av (Tish’a B’Av)	4. The Ninth of Av (Tish'a B'Av)	ד – תשעה באב
5 – The Fast of Gedalyah (Tzom Gedalyah)	5. The Fast of Gedalyah (Tzom Gedalyah)	ה – צום גדליה
7 - The Laws of the Minor Fasts	7. The Laws of the Minor Fasts	ז - דיני הצומות הקלים
1 – The Current Status of the Minor Fasts	1. The Current Status of the Minor Fasts	א – מעמד הצומות בימינו
2 – The Laws of the Minor Fasts	2. The Laws of the Minor Fasts	ב – דין הצומות הקלים
3 – The Duration of the Minor Fasts	3. The Duration of the Minor Fasts	ג – זמן הצומות הקלים
4 – May One Eat and Drink if He Arises Before Daybreak?	4. May One Eat and Drink if He Arises Before Daybreak?	ד – האם הקם לפני עלות השחר רשאי לאכול ולשתות
5 – Rinsing One’s Mouth	5. Rinsing One's Mouth	ה – שטיפת הפה
6 – One Who Forgets it’s a Fast Day	6. One Who Forgets it's a Fast Day	ו – שכח שהוא צום
7 – The Infirm are Exempt from Fasting	7. The Infirm are Exempt from Fasting	ז – חולים פטורים מהצום
8 – Pregnant and Nursing Women on Tish’a B’Av and the Minor Fast Days	8. Pregnant and Nursing Women on Tish'a B'Av and the Minor Fast Days	ח – מעוברות ומיניקות בתשעה באב ובצומות הקלים
9 – Children, Bridegrooms, and Soldiers	9. Children, Bridegrooms, and Soldiers	ט – קטנים חתנים וחיילים
10 – The Aneinu Prayer	10. The Aneinu Prayer	י – תפילת עננו
11 – The Torah Reading for Fast Days	11. The Torah Reading for Fast Days	יא – קריאת 'ויחל' בתענית
12 – Birkat Kohanim (the Priestly Blessing) During Mincha	12. Birkat Kohanim (the Priestly Blessing) During Mincha	יב – ברכת כהנים במנחה
8 - The Customs of the Three Weeks	8. The Customs of the Three Weeks	ח - מנהגי שלושת השבועות
03. Playing Music and Singing at a Se’udat Mitzva	03. Playing Music and Singing at a Se'udat Mitzva	ג – נגינה ושירה בסעודות מצווה
07. Reciting She-heĥeyanu During the Three Weeks	07. Reciting She'heheyanu During the Three Weeks	ז – שהחיינו בשלושת השבועות
08. In Which Cases May One Recite She-heĥeyanu?	08. In Which Cases May One Recite She'heheyanu?	ח – באיזה מקרים מותר לברך 'שהחיינו'
11. Shaving One’s Beard During the Three Weeks	11. Shaving One's Beard During the Three Weeks	יא – גילוח זקן בשלושת השבועות
15. Meat and Wine on Shabbat Ĥazon and at a Se’udat Mitzva	15. Meat and Wine on Shabbat Hazon and at a Se'udat Mitzva	טו – בשר ויין בשבת חזון ובסעודות מצווה
20. Children’s Clothing and Hospital Garb	20. Children's Clothing and Hospital Garb	כ – בגדי קטנים ובתי חולים
22. Shabbat Ĥazon	22. Shabbat Hazon	כב – שבת חזון
23. “The Week of Tisha Be-Av” when Tisha Be-Av is Postponed to Sunday	23. "The Week of Tisha BeAv" when Tisha BeAv is Postponed to Sunday	כג – 'שבוע שחל בו' כשתשעה באב נדחה ליום ראשון
9 - The Eve of Tish’a B’Av	9. The Eve of Tish'a B'Av	ט - ערב תשעה באב
1 – The Meal Before the Fast (Seudah HaMafseket)	1. The Meal Before the Fast (Seudah HaMafseket)	א – סעודה מפסקת
2 – Which Foods are Prohibited?	2. Which Foods are Prohibited?	ב – הגדרת המאכלים האסורים
3 – Customs of the Seudah HaMafseket	3. Customs of the Seudah HaMafseket	ג – מנהגי סעודה מפסקת
4 – The Transition Between Shabbat and Tish’a B’Av When the Fast Falls Out on Sunday	4. The Transition Between Shabbat and Tish'a B'Av When the Fast Falls Out on Sunday	ד – המעבר בין שבת לתשעה באב שחל במוצאי שבת
5 – Havdalah on Tish’a B’Av When it Falls Out on Saturday Night	5. Havdalah on Tish'a B'Av When it Falls Out on Saturday Night	ה – כיצד מבדילים במוצאי שבת שהוא ט' באב
10 - The Laws of Tish’a B’Av	10. The Laws of Tish'a B'Av	י - הלכות תשעה באב
1 – Instituting the Fast of Tish’a B’Av	1. Instituting the Fast of Tish'a B'Av	א – תקנת צום תשעה באב
2 – General Rules of the Fasts	2. General Rules of the Fasts	ב – כללי הצומות
3 – Eating and Drinking and the Laws of Sick People and Postpartum Women	3. Eating and Drinking and the Laws of Sick People and Postpartum Women	ג – איסור אכילה ושתייה ודין חולים ויולדת
4 – Pregnant and Nursing Women	4. Pregnant and Nursing Women	ד – מעוברות ומיניקות
5 – Washing	5. Washing	ה – רחיצה
6 – Mitzvah-Related Washing	6. Mitzvah Related Washing	ו – רחיצה של מצווה
7 – Anointing, Smelling Spices, and Smoking	7. Anointing, Smelling Spices, and Smoking	ז – סיכה, בשמים ועישון
8 – Wearing Shoes	8. Wearing Shoes	ח – נעילת הסנדל
9 – Marital Relations	9. Marital Relations	ט – תשמיש המיטה
10 – Torah Study	10. Torah Study	י – תלמוד תורה
11 – Greeting One Another	11. Greeting One Another	יא – שאלת שלום
12 – Trips and Visiting the Western Wall (Kotel)	12. Trips and Visiting the Western Wall (Kotel)	יב – טיול והליכה לכותל המערבי
13 – Sitting and Lying on the Ground	13. Sitting and Lying on the Ground	יג – ישיבה ושכיבה על הארץ
14 – Doing Work	14. Doing Work	יד – עשיית מלאכה
15 – The Reading of Eichah and Dimming the Lights	15. The Reading of Eichah and Dimming the Lights	טו – קריאת איכה והחשכת האור
16 – Anneinu, Nacheim, the Priestly Blessings, and Tachanun	16. Anneinu, Nacheim, the Priestly Blessings, and Tachanun	טז – עננו, נחם, ברכת כהנים ותחנון
17 – Removing the Curtain from Before the Ark; Tallit and Tefillin	17. Removing the Curtain from Before the Ark; Tallit and Tefillin	יז – הסרת הפרוכת, טלית ותפילין
18 – Words of Torah in our Prayers and the Blessing of SheAsah Li Kol Tzorki	18. Words of Torah in our Prayers and the Blessing of SheAsah Li Kol Tzorki	יח – דברי תורה שבתפילה וברכת 'שעשה לי כל צרכי'
19 – The Laws of the Tenth of Av	19. The Laws of the Tenth of Av	יט – דין יום עשירי באב
20 – When Tish’a B’Av Falls Out on Shabbat and is Postponed	20. When Tish'a B'Av Falls Out on Shabbat and is Postponed	כ – דיני תשעה באב שחל בשבת ונדחה
21 – Minors	21. Minors	כא – דין קטנים
11 - Hanuka	11. Hanuka	יא - ימי החנוכה
01. The Enduring Holiday of Ĥanuka	01. The Enduring Holiday of Hanuka	א – ימי החנוכה לדורות
07. Adding a New Candle on Each Day of Ĥanuka	07. Adding a New Candle on Each Day of Hanuka	ז – מוסיף והולך עד שמונה
08. Al Ha-nisim, Hallel, and Torah Reading	08. Al Ha'nisim, Hallel, and Torah Reading	ח – על הנסים, הלל וקריאה בתורה
10. Festive Meals on Ĥanuka	10. Festive Meals on Hanuka	י – סעודות בחנוכה
12 - Lighting the Chanukah Candles	12. Lighting the Chanukah Candles	יב - הדלקת נרות חנוכה
01. The Mitzva to Light Ĥanuka Candles	01. The Mitzva to Light Hanuka Candles	א – מצוות הדלקת נרות חנוכה
02. The Number of Candles and the Mehadrin min Ha-mehadrin Practice	02. The Number of Candles and the Mehadrin min Ha'mehadrin Practice	ב – מספר הנרות ומנהג מהדרין מן המהדרין
05. The Berakhot and Ha-nerot Halalu	05. The Berakhot and Ha'nerot Halalu	ה – הברכות ו'הנרות הללו'
13 - When and Where to Light Ĥanuka Candles	13. When and Where to Light Hanuka Candles	יג - דיני המקום והזמן
06. Delaying Candle-Lighting When Necessary	06. Delaying Candle Lighting When Necessary	ו – בשעת הצורך מותר לאחר את זמן ההדלקה
08. Lighting Before Shki’a or Late at Night in Pressing Circumstances	08. Lighting Before Shki'a or Late at Night in Pressing Circumstances	ח – הדלקה בשעת הדחק לפני השקיעה ומאוחר בלילה
10. Guests on Shabbat Ĥanuka	10. Guests on Shabbat Hanuka	י – משפחה שמתארחת בשבת
14 - The Month of Adar	14. The Month of Adar	יד - חודש אדר
15 - Purim and Reading the Megillah	15. Purim and Reading the Megillah	טו - פורים ומקרא מגילה
3 – Establishing Purim as an Everlasting Holiday	3. Establishing Purim as an Everlasting Holiday	ג – קביעת פורים לדורות
14. Al Ha-nisim, Torah Reading, Eulogies, and Taĥanun	14. Al Ha'nisim, Torah Reading, Eulogies, and Tahanun	יד – על הנסים, קריאת התורה, הספד ותחנון
16 - The Mitzvot of Joy and Kindness	16. The Mitzvot of Joy and Kindness	טז - מצוות השמחה והחסד
03. Matanot La-evyonim	03. Matanot La'evyonim	ג – מתנות לאביונים
04. Mishlo’aĥ Manot	04. Mishlo'ah Manot	ד – משלוח מנות
05. Types of Foods for Mishlo’aĥ Manot	05. Types of Foods for Mishlo'ah Manot	ה – באיזה מנות מקיימים המצווה
06. Who Is Obligated in Mishlo’aĥ Manot and Matanot La-evyonim?	06. Who Is Obligated in Mishlo'ah Manot and Matanot La'evyonim?	ו – החייבים במשלוח מנות ומתנות לאביונים
07. The Proper Time for Matanot La-evyonim and Mishlo’aĥ Manot	07. The Proper Time for Matanot La'evyonim and Mishlo'ah Manot	ז – זמן נתינת המתנות והמנות ושליחות בקיומם
08. Between Mishlo’aĥ Manot and Matanot La-evyonim	08. Between Mishlo'ah Manot and Matanot La'evyonim	ח – בין משלוח מנות למתנות לאביונים
09. The Mitzva to Rejoice and Eat a Se’uda	09. The Mitzva to Rejoice and Eat a Se'uda	ט – מצוות השמחה והסעודה
14. Can a Drunk or Tipsy Person Recite Berakhot and Pray Ma’ariv?	14. Can a Drunk or Tipsy Person Recite Berakhot and Pray Ma'ariv?	יד – דין שתוי ושיכור בברכות ותפילת ערבית
15. Scheduling the Se’uda when Purim is on Friday	15. Scheduling the Se'uda when Purim is on Friday	טו – זמן הסעודה בפורים שבערב שבת
17 - Walled and Unwalled Cities	17. Walled and Unwalled Cities	יז - דיני פרזים ומוקפים
05. Purim Ha-meshulash	05. Purim Ha'meshulash	ה – פורים המשולש
01 - Introduction	01. Introduction	א - פתיחה
04. Shabbat and the Holidays – the Mitzvot and Their Punishments	04. Shabbat and the Holidays. the Mitzvot and Their Punishments	ד – השבת והחגים – במצוות ובעונשים
07. The Festive Meals – “Mikra’ei Kodesh”	07. The Festive Meals. "Mikra'ei Kodesh"	ז – סעודות החג – מקראי קודש
08. The Mitzva of Simḥa	08. The Mitzva of Simha	ח – מצוות השמחה
02 - Positive Yom Tov Obligations	02. Positive Yom Tov Obligations	ב - דיני עשה ביום טוב
06. Birkat Ha-mazon	06. Birkat Ha'mazon	ו – ברכת המזון
08. Torah Reading on Yom Tov and Ḥol Ha-mo’ed	08. Torah Reading on Yom Tov and Hol Ha'moed	ח – קריאת התורה בחג ובחול המועד
09. The Musaf Amida and Ve-te’erav	09. The Musaf Amida and Ve'te'erav	ט – תפילת מוסף – וְתֶעֱרַב
13. Isru Ḥag	13. Isru Hag	י"ג – איסרו חג
03 - The Principles of the Melakhot	03. The Principles of the Melakhot	ג - כללי המלאכות
05. For Non-Jews and for Animals	05. For Non Jews and for Animals	ה – עבור נוכרים ובעלי חיים
06. Shaveh Le-khol Nefesh	06. Shaveh Le'khol Nefesh	ו – שווה לכל נפש
04 - Melakhot Pertaining to Food	04. Melakhot Pertaining to Food	ד - מלאכות המאכלים
01. Kotzer, Dash, and Soḥet	01. Kotzer, Dash, and Sohet	א – קוצר, דש וסוחט
02. Toḥen	02. Tohen	ב – טוחן
06. Laws Pertaining to Sheḥita	06. Laws Pertaining to Shehita	ו – שחיטה ודיניה
07. Sheḥita Nowadays	07. Shehita Nowadays	ז – שחיטה כיום
05 - Mav’ir, Mekhabeh, and Electricity	05. Mav'ir, Mekhabeh, and Electricity	ה - הבערה כיבוי וחשמל
01. Mav’ir	01. Mav'ir	א – הבערה
06 - Hotza’ah and Muktzeh	06. Hotza'ah and Muktzeh	ו - הוצאה ומוקצה
01. The Melakha of Hotza’ah	01. The Melakha of Hotza'ah	א – מלאכת 'הוצאה'
04. Teḥumin	04. Tehumin	ד – תחומין
07 - Various Laws of Yom Tov	07. Various Laws of Yom Tov	ז - מדיני יום טוב
08 - Eruv Tavshilin	08. Eruv Tavshilin	ח - עירוב תבשילין
09 - Yom Tov Sheni	09. Yom Tov Sheni	ט - יום טוב שני של גלויות
10 - The Mitzvot of Ḥol Ha-mo’ed	10. The Mitzvot of Hol Ha'moed	י - מצוות חול המועד
01. Ḥol Ha-mo’ed	01. Hol Ha'moed	א – חול המועד
07. The Spiritual Significance of Ḥol Ha-mo’ed	07. The Spiritual Significance of Hol Ha'moed	ז – משמעותו הרוחנית של חול המועד
11 - Melakha on Ḥol Ha-mo’ed	11. Melakha on Hol Ha'moed	יא - מלאכת חול המועד
18. Jews and Non-Jews on Ḥol Ha-mo’ed	18. Jews and Non Jews on Hol Ha'moed	י"ח – ישראל וגוי בחול המועד
12 - When Work Is Permitted on Ḥol Ha-mo’ed	12. When Work Is Permitted on Hol Ha'moed	יב - היתרי עבודה במועד
02. Davar Ha-aved (Preventing a Loss)	02. Davar Ha'aved (Preventing a Loss)	ב – מלאכת דבר האבד
03. Not to Plan Work for Ḥol Ha-Mo’ed	03. Not to Plan Work for Hol HaMo'ed	ג – שלא יכוון מלאכתו למועד
04. Various Laws of Davar Ha-aved	04. Various Laws of Davar Ha'aved	ד – מדיני מלאכת דבר האבד
11. Time-Sensitive Mitzva Needs	11. Time Sensitive Mitzva Needs	י"א – לצורך מצווה עוברת הותרה מלאכת אומן
12. Building Synagogues, Schools, and a Ma’akeh	12. Building Synagogues, Schools, and a Ma'akeh	י"ב – בית כנסת ובית ספר ומעקה
13 - Shavu’ot	13. Shavu'ot	יג - חג השבועות
01. Shavu’ot and Its Relationship with Pesaḥ	01. Shavu'ot and Its Relationship with Pesah	א – חג השבועות ויחסו לחג הפסח
02. Preparation and Purification During Sefirat Ha-omer	02. Preparation and Purification During Sefirat Ha'omer	ב – תהליך ההכנה וההיטהרות בספירת העומר
04. Ḥag Ha-Katzir	04. Hag HaKatzir	ד – חג הקציר
05. Yom Ha-Bikurim	05. Yom HaBikurim	ה – יום הביכורים
07. Extra Joy – Spiritual and Physical	07. Extra Joy. Spiritual and Physical	ז – שמחה יתירה – רוחנית וגשמית
08. Shavu’ot Night Learning	08. Shavu'ot Night Learning	ח – לימוד ליל שבועות
10. Birkhot Ha-shaḥar and Other Laws for Those Who Remain Awake All Night	10. Birkhot Ha'shahar and Other Laws for Those Who Remain Awake All Night	י – ברכות השחר ועוד דינים לערים בלילה
15. The Six Days Following Shavu’ot	15. The Six Days Following Shavu'ot	ט"ו – ששת הימים שלאחר חג השבועות
9 – A Time of Atonement and Yom Kippur Katan	9. A Time of Atonement and Yom Kippur Katan	ט – זמן כפרה ויום כיפור קטן
10 – Ya’aleh VeYavo in Shemoneh Esrei	10. Ya'aleh VeYavo in Shemoneh Esrei	י – יעלה ויבוא בתפילה 
11 -Ya’aleh VeYavo in Grace After Meals	11. Ya'aleh VeYavo in Grace After Meals	יא – יעלה ויבוא בברכת המזון 
12 – Hallel on Rosh Chodesh	12. Hallel on Rosh Chodesh	יב – הלל בראש חודש
13 – Customs Relating to the Recital of Hallel	13. Customs Relating to the Recital of Hallel	יג – מנהגי אמירת ההלל
14 – The Torah Reading and Musaf Service	14. The Torah Reading and Musaf Service	יד – קריאת התורה ומוסף 
15 – The Meaning Behind the Blessing of the Moon	15. The Meaning Behind the Blessing of the Moon	טו – משמעות ברכת הלבנה 
16 – The Laws of Reciting the Blessing Joyously	16. The Laws of Reciting the Blessing Joyously	טז – דיני אמירתה בשמחה
17 – Seeing the New Moon	17. Seeing the New Moon	יז – ראיית הלבנה
18 – The Proper Time for Birkat HaLevanah	18. The Proper Time for Birkat HaLevanah	יח – זמן ברכת הלבנה
09. Ta’anit Esther	09. Ta'anit Esther	ט – תענית אסתר
10. Commemoration of the Half-Shekel	10. Commemoration of the Half Shekel	י – זכר למחצית השקל 
10. Women’s Mitzva of Simḥa	10. Women's Mitzva of Simha	י – מצוות שמחה לנשים
17. Visiting One’s Rabbi	17. Visiting One's Rabbi	י"ז – הקבלת פני רבו ברגל
01. Mav’ir	01. Mav'ir	ב – כיבוי